"unitid","institution name","year","C2019_A.First or Second Major","C2019_A.CIP Code -  2010 Classification","CipTitle","C2019_A.Award Level code","C2019_A_RV.Grand total","C2019_A_RV.Grand total men","C2019_A_RV.Grand total women","C2019_A_RV.American Indian or Alaska Native total","C2019_A_RV.American Indian or Alaska Native men","C2019_A_RV.American Indian or Alaska Native women","C2019_A_RV.Asian total","C2019_A_RV.Asian men","C2019_A_RV.Asian women","C2019_A_RV.Black or African American total","C2019_A_RV.Black or African American men","C2019_A_RV.Black or African American women","C2019_A_RV.Hispanic or Latino total","C2019_A_RV.Hispanic or Latino men","C2019_A_RV.Hispanic or Latino women","C2019_A_RV.Native Hawaiian or Other Pacific Islander total","C2019_A_RV.Native Hawaiian or Other Pacific Islander men","C2019_A_RV.Native Hawaiian or Other Pacific Islander women","C2019_A_RV.White total","C2019_A_RV.White men","C2019_A_RV.White women","C2019_A_RV.Two or more races total","C2019_A_RV.Two or more races men","C2019_A_RV.Two or more races women","C2019_A_RV.Race/ethnicity unknown total","C2019_A_RV.Race/ethnicity unknown men","C2019_A_RV.Race/ethnicity unknown women","C2019_A_RV.Nonresident alien total","C2019_A_RV.Nonresident alien men","C2019_A_RV.Nonresident alien women","IDX_C"
"100654","Alabama A & M University","2019","First major","'14'","Engineering","Bachelor's degree","67","52","15","0","0","0","0","0","0","62","47","15","0","0","0","1","1","0","0","0","0","0","0","0","2","2","0","2","2","0","-2"
"100654","Alabama A & M University","2019","First major","'14'","Engineering","Master's degree","9","6","3","0","0","0","0","0","0","8","5","3","0","0","0","0","0","0","0","0","0","0","0","0","1","1","0","0","0","0","-2"
"100663","University of Alabama at Birmingham","2019","First major","'14'","Engineering","Bachelor's degree","167","119","48","1","0","1","14","10","4","15","9","6","14","9","5","0","0","0","111","83","28","3","1","2","2","2","0","7","5","2","-2"
"100663","University of Alabama at Birmingham","2019","First major","'14'","Engineering","Master's degree","204","166","38","0","0","0","8","6","2","28","18","10","5","5","0","2","2","0","97","79","18","4","4","0","4","4","0","56","48","8","-2"
"100663","University of Alabama at Birmingham","2019","First major","'14'","Engineering","Doctor's degree - research/scholarship","19","17","2","0","0","0","2","2","0","2","2","0","1","1","0","0","0","0","6","4","2","0","0","0","0","0","0","8","8","0","-2"
"100706","University of Alabama in Huntsville","2019","First major","'14'","Engineering","Bachelor's degree","383","306","77","7","5","2","21","17","4","28","22","6","12","11","1","1","1","0","284","225","59","4","4","0","10","8","2","16","13","3","-2"
"100706","University of Alabama in Huntsville","2019","First major","'14'","Engineering","Master's degree","115","94","21","1","0","1","3","3","0","2","1","1","2","1","1","0","0","0","68","57","11","0","0","0","3","3","0","36","29","7","-2"
"100706","University of Alabama in Huntsville","2019","First major","'14'","Engineering","Doctor's degree - research/scholarship","22","16","6","1","1","0","0","0","0","0","0","0","0","0","0","0","0","0","12","10","2","0","0","0","0","0","0","9","5","4","-2"
"100724","Alabama State University","2019","First major","'14'","Engineering","Bachelor's degree","1","0","1","0","0","0","0","0","0","1","0","1","0","0","0","0","0","0","0","0","0","0","0","0","0","0","0","0","0","0","-2"
"100751","The University of Alabama","2019","First major","'14'","Engineering","Bachelor's degree","899","661","238","4","3","1","15","10","5","39","26","13","36","26","10","1","0","1","731","534","197","21","11","10","2","2","0","50","49","1","-2"
"100751","The University of Alabama","2019","First major","'14'","Engineering","Master's degree","72","55","17","0","0","0","0","0","0","2","1","1","1","1","0","0","0","0","48","37","11","0","0","0","0","0","0","21","16","5","-2"
"100751","The University of Alabama","2019","First major","'14'","Engineering","Doctor's degree - research/scholarship","31","24","7","0","0","0","0","0","0","0","0","0","0","0","0","0","0","0","10","6","4","0","0","0","0","0","0","21","18","3","-2"
"100751","The University of Alabama","2019","Second major","'14'","Engineering","Bachelor's degree","7","5","2","0","0","0","0","0","0","0","0","0","0","0","0","0","0","0","7","5","2","0","0","0","0","0","0","0","0","0","-2"
"100858","Auburn University","2019","First major","'14'","Engineering","Bachelor's degree","966","781","185","4","3","1","41","32","9","42","25","17","30","24","6","1","1","0","801","657","144","5","2","3","6","6","0","36","31","5","-2"
"100858","Auburn University","2019","First major","'14'","Engineering","Master's degree","255","197","58","0","0","0","4","3","1","2","0","2","7","5","2","0","0","0","97","76","21","3","3","0","0","0","0","142","110","32","-2"
"100858","Auburn University","2019","First major","'14'","Engineering","Doctor's degree - research/scholarship","70","55","15","0","0","0","2","1","1","0","0","0","1","1","0","0","0","0","14","12","2","0","0","0","0","0","0","53","41","12","-2"
"100858","Auburn University","2019","Second major","'14'","Engineering","Bachelor's degree","1","0","1","0","0","0","1","0","1","0","0","0","0","0","0","0","0","0","0","0","0","0","0","0","0","0","0","0","0","0","-2"
"100937","Birmingham-Southern College","2019","First major","'14'","Engineering","Bachelor's degree","4","2","2","0","0","0","0","0","0","1","1","0","0","0","0","0","0","0","3","1","2","0","0","0","0","0","0","0","0","0","-2"
"102049","Samford University","2019","First major","'14'","Engineering","Bachelor's degree","4","3","1","0","0","0","0","0","0","1","0","1","0","0","0","0","0","0","1","1","0","0","0","0","0","0","0","2","2","0","-2"
"102094","University of South Alabama","2019","First major","'14'","Engineering","Bachelor's degree","208","181","27","1","1","0","6","4","2","10","9","1","5","3","2","0","0","0","128","111","17","7","5","2","6","5","1","45","43","2","-2"
"102094","University of South Alabama","2019","First major","'14'","Engineering","Master's degree","24","18","6","0","0","0","0","0","0","1","1","0","0","0","0","0","0","0","13","8","5","1","1","0","0","0","0","9","8","1","-2"
"102094","University of South Alabama","2019","First major","'14'","Engineering","Doctor's degree - research/scholarship","4","3","1","0","0","0","0","0","0","0","0","0","0","0","0","0","0","0","4","3","1","0","0","0","0","0","0","0","0","0","-2"
"102094","University of South Alabama","2019","Second major","'14'","Engineering","Bachelor's degree","1","0","1","0","0","0","0","0","0","0","0","0","0","0","0","0","0","0","1","0","1","0","0","0","0","0","0","0","0","0","-2"
"102234","Spring Hill College","2019","First major","'14'","Engineering","Bachelor's degree","0","0","0","0","0","0","0","0","0","0","0","0","0","0","0","0","0","0","0","0","0","0","0","0","0","0","0","0","0","0","-2"
"102377","Tuskegee University","2019","First major","'14'","Engineering","Bachelor's degree","86","57","29","0","0","0","0","0","0","47","28","19","1","1","0","0","0","0","0","0","0","0","0","0","38","28","10","0","0","0","-2"
"102377","Tuskegee University","2019","First major","'14'","Engineering","Master's degree","6","5","1","0","0","0","0","0","0","3","3","0","1","1","0","0","0","0","0","0","0","0","0","0","2","1","1","0","0","0","-2"
"102553","University of Alaska Anchorage","2019","First major","'14'","Engineering","Bachelor's degree","108","82","26","4","2","2","9","5","4","1","1","0","5","4","1","0","0","0","67","51","16","16","15","1","3","3","0","3","1","2","-2"
"102553","University of Alaska Anchorage","2019","First major","'14'","Engineering","Master's degree","35","25","10","1","1","0","1","1","0","0","0","0","2","0","2","1","0","1","17","15","2","3","2","1","3","2","1","7","4","3","-2"
"102614","University of Alaska Fairbanks","2019","First major","'14'","Engineering","Bachelor's degree","94","72","22","2","1","1","3","2","1","2","2","0","7","6","1","0","0","0","49","35","14","6","4","2","23","20","3","2","2","0","-2"
"102614","University of Alaska Fairbanks","2019","First major","'14'","Engineering","Master's degree","22","20","2","0","0","0","1","0","1","0","0","0","0","0","0","0","0","0","7","6","1","0","0","0","5","5","0","9","9","0","-2"
"102614","University of Alaska Fairbanks","2019","First major","'14'","Engineering","Doctor's degree - research/scholarship","1","1","0","0","0","0","0","0","0","0","0","0","0","0","0","0","0","0","0","0","0","0","0","0","0","0","0","1","1","0","-2"
"104151","Arizona State University Campus Immersion","2019","First major","'14'","Engineering","Bachelor's degree","1345","1069","276","12","8","4","109","81","28","19","13","6","221","167","54","3","1","2","654","513","141","43","29","14","12","9","3","272","248","24","-2"
"104151","Arizona State University Campus Immersion","2019","First major","'14'","Engineering","Master's degree","806","628","178","0","0","0","39","29","10","2","2","0","53","39","14","0","0","0","170","140","30","10","6","4","0","0","0","532","412","120","-2"
"104151","Arizona State University Campus Immersion","2019","First major","'14'","Engineering","Doctor's degree - research/scholarship","132","101","31","1","1","0","2","2","0","0","0","0","5","3","2","0","0","0","30","18","12","0","0","0","3","3","0","91","74","17","-2"
"104160","Arizona Western College","2019","First major","'14'","Engineering","Associate's degree","24","22","2","0","0","0","1","1","0","1","1","0","18","16","2","0","0","0","1","1","0","0","0","0","2","2","0","1","1","0","-2"
"104179","University of Arizona","2019","First major","'14'","Engineering","Bachelor's degree","617","477","140","6","4","2","37","24","13","9","8","1","136","109","27","0","0","0","308","232","76","25","18","7","11","8","3","85","74","11","-2"
"104179","University of Arizona","2019","First major","'14'","Engineering","Master's degree","174","129","45","3","3","0","9","7","2","4","3","1","13","11","2","0","0","0","70","49","21","5","5","0","15","12","3","55","39","16","-2"
"104179","University of Arizona","2019","First major","'14'","Engineering","Doctor's degree - research/scholarship","51","36","15","0","0","0","2","2","0","2","0","2","0","0","0","0","0","0","7","5","2","0","0","0","1","1","0","39","28","11","-2"
"104425","Cochise County Community College District","2019","First major","'14'","Engineering","Associate's degree","13","9","4","0","0","0","0","0","0","1","0","1","9","7","2","0","0","0","2","2","0","0","0","0","0","0","0","1","0","1","-2"
"104586","Embry-Riddle Aeronautical University-Prescott","2019","First major","'14'","Engineering","Bachelor's degree","172","132","40","1","0","1","8","6","2","2","2","0","16","14","2","0","0","0","111","86","25","11","9","2","8","6","2","15","9","6","-2"
"104586","Embry-Riddle Aeronautical University-Prescott","2019","Second major","'14'","Engineering","Bachelor's degree","3","3","0","0","0","0","0","0","0","0","0","0","1","1","0","0","0","0","1","1","0","0","0","0","0","0","0","1","1","0","-2"
"104717","Grand Canyon University","2019","First major","'14'","Engineering","Bachelor's degree","40","34","6","0","0","0","0","0","0","2","2","0","5","4","1","0","0","0","27","24","3","1","0","1","1","1","0","4","3","1","-2"
"105154","Mesa Community College","2019","First major","'14'","Engineering","Associate's degree","1","1","0","0","0","0","0","0","0","0","0","0","0","0","0","0","0","0","1","1","0","0","0","0","0","0","0","0","0","0","-2"
"105206","Mohave Community College","2019","First major","'14'","Engineering","Associate's degree","4","4","0","0","0","0","0","0","0","0","0","0","0","0","0","0","0","0","3","3","0","1","1","0","0","0","0","0","0","0","-2"
"105297","Dine College","2019","First major","'14'","Engineering","Associate's degree","4","4","0","4","4","0","0","0","0","0","0","0","0","0","0","0","0","0","0","0","0","0","0","0","0","0","0","0","0","0","-2"
"105330","Northern Arizona University","2019","First major","'14'","Engineering","Bachelor's degree","380","314","66","13","9","4","15","12","3","3","2","1","45","37","8","0","0","0","141","106","35","14","10","4","51","43","8","98","95","3","-2"
"105330","Northern Arizona University","2019","First major","'14'","Engineering","Master's degree","26","20","6","0","0","0","2","1","1","0","0","0","4","3","1","0","0","0","11","7","4","1","1","0","0","0","0","8","8","0","-2"
"105330","Northern Arizona University","2019","First major","'14'","Engineering","Doctor's degree - research/scholarship","6","4","2","0","0","0","0","0","0","0","0","0","0","0","0","0","0","0","6","4","2","0","0","0","0","0","0","0","0","0","-2"
"105330","Northern Arizona University","2019","Second major","'14'","Engineering","Bachelor's degree","1","0","1","0","0","0","0","0","0","0","0","0","1","0","1","0","0","0","0","0","0","0","0","0","0","0","0","0","0","0","-2"
"105349","Northland Pioneer College","2019","First major","'14'","Engineering","Associate's degree","1","1","0","0","0","0","0","0","0","0","0","0","0","0","0","0","0","0","1","1","0","0","0","0","0","0","0","0","0","0","-2"
"105525","Pima Community College","2019","First major","'14'","Engineering","Associate's degree","4","3","1","0","0","0","0","0","0","0","0","0","1","1","0","0","0","0","1","1","0","1","1","0","1","0","1","0","0","0","-2"
"106148","Yavapai College","2019","First major","'14'","Engineering","Associate's degree","1","1","0","0","0","0","0","0","0","0","0","0","0","0","0","0","0","0","1","1","0","0","0","0","0","0","0","0","0","0","-2"
"106245","University of Arkansas at Little Rock","2019","First major","'14'","Engineering","Bachelor's degree","34","33","1","0","0","0","1","1","0","1","1","0","1","1","0","0","0","0","26","25","1","1","1","0","0","0","0","4","4","0","-2"
"106245","University of Arkansas at Little Rock","2019","First major","'14'","Engineering","Master's degree","2","2","0","0","0","0","0","0","0","0","0","0","0","0","0","0","0","0","1","1","0","0","0","0","0","0","0","1","1","0","-2"
"106245","University of Arkansas at Little Rock","2019","First major","'14'","Engineering","Doctor's degree - research/scholarship","7","6","1","0","0","0","0","0","0","0","0","0","0","0","0","0","0","0","1","1","0","0","0","0","0","0","0","6","5","1","-2"
"106397","University of Arkansas","2019","First major","'14'","Engineering","Bachelor's degree","513","375","138","4","3","1","17","14","3","21","15","6","39","29","10","0","0","0","337","255","82","15","7","8","1","1","0","79","51","28","-2"
"106397","University of Arkansas","2019","First major","'14'","Engineering","Master's degree","107","89","18","1","0","1","3","3","0","6","5","1","5","4","1","0","0","0","58","53","5","3","2","1","1","1","0","30","21","9","-2"
"106397","University of Arkansas","2019","First major","'14'","Engineering","Doctor's degree - research/scholarship","33","21","12","1","1","0","1","0","1","2","1","1","1","0","1","0","0","0","9","6","3","0","0","0","0","0","0","19","13","6","-2"
"106458","Arkansas State University","2019","First major","'14'","Engineering","Bachelor's degree","51","41","10","0","0","0","0","0","0","1","1","0","0","0","0","0","0","0","40","32","8","4","3","1","0","0","0","6","5","1","-2"
"106458","Arkansas State University","2019","First major","'14'","Engineering","Master's degree","5","5","0","0","0","0","0","0","0","0","0","0","0","0","0","0","0","0","0","0","0","0","0","0","0","0","0","5","5","0","-2"
"106467","Arkansas Tech University","2019","First major","'14'","Engineering","Bachelor's degree","132","126","6","0","0","0","1","0","1","3","2","1","3","2","1","0","0","0","74","71","3","5","5","0","0","0","0","46","46","0","-2"
"106467","Arkansas Tech University","2019","First major","'14'","Engineering","Master's degree","9","9","0","0","0","0","0","0","0","0","0","0","0","0","0","0","0","0","2","2","0","0","0","0","0","0","0","7","7","0","-2"
"106704","University of Central Arkansas","2019","First major","'14'","Engineering","Bachelor's degree","0","0","0","0","0","0","0","0","0","0","0","0","0","0","0","0","0","0","0","0","0","0","0","0","0","0","0","0","0","0","-2"
"106980","National Park College","2019","First major","'14'","Engineering","Associate's degree","3","3","0","0","0","0","0","0","0","0","0","0","0","0","0","0","0","0","3","3","0","0","0","0","0","0","0","0","0","0","-2"
"106999","University of Arkansas Community College-Batesville","2019","First major","'14'","Engineering","Associate's degree","0","0","0","0","0","0","0","0","0","0","0","0","0","0","0","0","0","0","0","0","0","0","0","0","0","0","0","0","0","0","-2"
"107044","Harding University","2019","First major","'14'","Engineering","Bachelor's degree","41","37","4","0","0","0","1","1","0","1","1","0","2","2","0","0","0","0","30","27","3","1","1","0","0","0","0","6","5","1","-2"
"107071","Henderson State University","2019","First major","'14'","Engineering","Bachelor's degree","5","5","0","0","0","0","0","0","0","0","0","0","0","0","0","0","0","0","5","5","0","0","0","0","0","0","0","0","0","0","-2"
"107141","John Brown University","2019","First major","'14'","Engineering","Bachelor's degree","27","21","6","1","1","0","0","0","0","0","0","0","1","1","0","0","0","0","19","15","4","1","1","0","2","0","2","3","3","0","-2"
"107460","North Arkansas College","2019","First major","'14'","Engineering","Associate's degree","0","0","0","0","0","0","0","0","0","0","0","0","0","0","0","0","0","0","0","0","0","0","0","0","0","0","0","0","0","0","-2"
"107512","Ouachita Baptist University","2019","First major","'14'","Engineering","Bachelor's degree","2","2","0","0","0","0","0","0","0","1","1","0","0","0","0","0","0","0","1","1","0","0","0","0","0","0","0","0","0","0","-2"
"107983","Southern Arkansas University Main Campus","2019","First major","'14'","Engineering","Bachelor's degree","11","11","0","0","0","0","1","1","0","0","0","0","1","1","0","0","0","0","8","8","0","0","0","0","0","0","0","1","1","0","-2"
"108092","University of Arkansas-Fort Smith","2019","First major","'14'","Engineering","Associate's degree","17","17","0","0","0","0","1","1","0","0","0","0","0","0","0","0","0","0","12","12","0","2","2","0","0","0","0","2","2","0","-2"
"108807","Allan Hancock College","2019","First major","'14'","Engineering","Associate's degree","13","10","3","0","0","0","1","1","0","0","0","0","8","6","2","0","0","0","4","3","1","0","0","0","0","0","0","0","0","0","-2"
"109208","American River College","2019","First major","'14'","Engineering","Associate's degree","24","23","1","0","0","0","7","7","0","1","1","0","6","6","0","0","0","0","9","8","1","0","0","0","0","0","0","1","1","0","-2"
"109350","Antelope Valley College","2019","First major","'14'","Engineering","Associate's degree","17","13","4","0","0","0","2","2","0","0","0","0","9","6","3","0","0","0","6","5","1","0","0","0","0","0","0","0","0","0","-2"
"109785","Azusa Pacific University","2019","First major","'14'","Engineering","Bachelor's degree","6","5","1","0","0","0","0","0","0","0","0","0","2","1","1","0","0","0","3","3","0","0","0","0","0","0","0","1","1","0","-2"
"109819","Bakersfield College","2019","First major","'14'","Engineering","Associate's degree","11","10","1","0","0","0","2","2","0","0","0","0","6","5","1","0","0","0","3","3","0","0","0","0","0","0","0","0","0","0","-2"
"110097","Biola University","2019","First major","'14'","Engineering","Bachelor's degree","4","2","2","0","0","0","1","1","0","0","0","0","0","0","0","0","0","0","2","0","2","0","0","0","1","1","0","0","0","0","-2"
"110246","Butte College","2019","First major","'14'","Engineering","Associate's degree","3","1","2","0","0","0","0","0","0","0","0","0","2","0","2","0","0","0","1","1","0","0","0","0","0","0","0","0","0","0","-2"
"110334","Cabrillo College","2019","First major","'14'","Engineering","Associate's degree","37","30","7","0","0","0","2","0","2","0","0","0","19","19","0","0","0","0","15","10","5","1","1","0","0","0","0","0","0","0","-2"
"110361","California Baptist University","2019","First major","'14'","Engineering","Bachelor's degree","95","71","24","0","0","0","4","0","4","1","1","0","27","20","7","0","0","0","53","42","11","7","5","2","3","3","0","0","0","0","-2"
"110361","California Baptist University","2019","First major","'14'","Engineering","Master's degree","21","17","4","0","0","0","1","0","1","0","0","0","1","1","0","0","0","0","1","1","0","0","0","0","0","0","0","18","15","3","-2"
"110404","California Institute of Technology","2019","First major","'14'","Engineering","Bachelor's degree","84","41","43","0","0","0","46","19","27","1","1","0","5","1","4","0","0","0","24","15","9","1","1","0","0","0","0","7","4","3","-2"
"110404","California Institute of Technology","2019","First major","'14'","Engineering","Master's degree","80","50","30","0","0","0","6","6","0","0","0","0","6","4","2","0","0","0","24","14","10","4","4","0","0","0","0","40","22","18","-2"
"110404","California Institute of Technology","2019","First major","'14'","Engineering","Doctor's degree - research/scholarship","86","72","14","0","0","0","15","13","2","1","1","0","3","3","0","0","0","0","24","20","4","0","0","0","0","0","0","43","35","8","-2"
"110413","California Lutheran University","2019","First major","'14'","Engineering","Bachelor's degree","1","1","0","0","0","0","0","0","0","0","0","0","0","0","0","0","0","0","0","0","0","0","0","0","1","1","0","0","0","0","-2"
"110422","California Polytechnic State University-San Luis Obispo","2019","First major","'14'","Engineering","Bachelor's degree","1208","907","301","0","0","0","181","128","53","8","6","2","182","138","44","0","0","0","654","503","151","93","71","22","53","34","19","37","27","10","-2"
"110422","California Polytechnic State University-San Luis Obispo","2019","First major","'14'","Engineering","Master's degree","168","132","36","0","0","0","16","13","3","1","1","0","16","11","5","0","0","0","98","80","18","13","7","6","15","12","3","9","8","1","-2"
"110422","California Polytechnic State University-San Luis Obispo","2019","Second major","'14'","Engineering","Bachelor's degree","1","1","0","0","0","0","0","0","0","0","0","0","0","0","0","0","0","0","1","1","0","0","0","0","0","0","0","0","0","0","-2"
"110422","California Polytechnic State University-San Luis Obispo","2019","Second major","'14'","Engineering","Master's degree","4","4","0","0","0","0","0","0","0","1","1","0","1","1","0","0","0","0","2","2","0","0","0","0","0","0","0","0","0","0","-2"
"110486","California State University-Bakersfield","2019","First major","'14'","Engineering","Bachelor's degree","80","65","15","1","0","1","9","6","3","1","0","1","34","30","4","0","0","0","10","8","2","1","1","0","17","13","4","7","7","0","-2"
"110510","California State University-San Bernardino","2019","First major","'14'","Engineering","Bachelor's degree","32","27","5","0","0","0","4","4","0","1","1","0","19","17","2","0","0","0","5","3","2","0","0","0","2","1","1","1","1","0","-2"
"110529","California State Polytechnic University-Pomona","2019","First major","'14'","Engineering","Bachelor's degree","880","680","200","0","0","0","226","164","62","13","11","2","307","247","60","0","0","0","203","160","43","39","30","9","30","24","6","62","44","18","-2"
"110529","California State Polytechnic University-Pomona","2019","First major","'14'","Engineering","Master's degree","72","59","13","0","0","0","19","16","3","0","0","0","17","12","5","0","0","0","19","15","4","2","2","0","6","6","0","9","8","1","-2"
"110529","California State Polytechnic University-Pomona","2019","Second major","'14'","Engineering","Bachelor's degree","3","3","0","0","0","0","0","0","0","0","0","0","0","0","0","0","0","0","0","0","0","0","0","0","1","1","0","2","2","0","-2"
"110538","California State University-Chico","2019","First major","'14'","Engineering","Bachelor's degree","226","205","21","1","1","0","16","15","1","4","3","1","57","54","3","1","1","0","95","86","9","4","2","2","24","22","2","24","21","3","-2"
"110538","California State University-Chico","2019","First major","'14'","Engineering","Master's degree","4","4","0","0","0","0","1","1","0","0","0","0","0","0","0","0","0","0","0","0","0","0","0","0","0","0","0","3","3","0","-2"
"110538","California State University-Chico","2019","Second major","'14'","Engineering","Bachelor's degree","9","9","0","0","0","0","2","2","0","0","0","0","3","3","0","0","0","0","3","3","0","0","0","0","1","1","0","0","0","0","-2"
"110556","California State University-Fresno","2019","First major","'14'","Engineering","Bachelor's degree","223","194","29","0","0","0","25","19","6","3","3","0","66","60","6","0","0","0","60","47","13","9","7","2","10","9","1","50","49","1","-2"
"110556","California State University-Fresno","2019","First major","'14'","Engineering","Master's degree","44","37","7","0","0","0","2","2","0","0","0","0","3","3","0","0","0","0","2","2","0","0","0","0","2","2","0","35","28","7","-2"
"110556","California State University-Fresno","2019","Second major","'14'","Engineering","Bachelor's degree","1","1","0","0","0","0","1","1","0","0","0","0","0","0","0","0","0","0","0","0","0","0","0","0","0","0","0","0","0","0","-2"
"110565","California State University-Fullerton","2019","First major","'14'","Engineering","Bachelor's degree","503","432","71","0","0","0","98","85","13","8","6","2","167","135","32","0","0","0","85","79","6","16","13","3","19","16","3","110","98","12","-2"
"110565","California State University-Fullerton","2019","First major","'14'","Engineering","Master's degree","350","264","86","0","0","0","50","35","15","8","8","0","47","35","12","0","0","0","35","31","4","8","6","2","14","12","2","188","137","51","-2"
"110565","California State University-Fullerton","2019","Second major","'14'","Engineering","Bachelor's degree","4","3","1","0","0","0","1","0","1","0","0","0","0","0","0","0","0","0","2","2","0","0","0","0","1","1","0","0","0","0","-2"
"110574","California State University-East Bay","2019","First major","'14'","Engineering","Bachelor's degree","44","41","3","0","0","0","11","10","1","2","2","0","7","7","0","0","0","0","2","2","0","1","1","0","1","1","0","20","18","2","-2"
"110583","California State University-Long Beach","2019","First major","'14'","Engineering","Bachelor's degree","697","558","139","1","1","0","167","131","36","12","12","0","236","186","50","0","0","0","142","117","25","27","19","8","32","30","2","80","62","18","-2"
"110583","California State University-Long Beach","2019","First major","'14'","Engineering","Master's degree","112","91","21","0","0","0","20","15","5","1","1","0","22","20","2","0","0","0","17","14","3","4","2","2","2","1","1","46","38","8","-2"
"110583","California State University-Long Beach","2019","Second major","'14'","Engineering","Bachelor's degree","14","7","7","0","0","0","6","3","3","0","0","0","4","1","3","0","0","0","2","2","0","0","0","0","1","1","0","1","0","1","-2"
"110592","California State University-Los Angeles","2019","First major","'14'","Engineering","Bachelor's degree","322","269","53","0","0","0","53","44","9","9","8","1","184","156","28","1","1","0","27","23","4","2","1","1","11","7","4","35","29","6","-2"
"110592","California State University-Los Angeles","2019","First major","'14'","Engineering","Master's degree","81","67","14","0","0","0","18","15","3","0","0","0","19","17","2","0","0","0","14","12","2","2","1","1","4","4","0","24","18","6","-2"
"110592","California State University-Los Angeles","2019","Second major","'14'","Engineering","Bachelor's degree","2","2","0","0","0","0","0","0","0","0","0","0","2","2","0","0","0","0","0","0","0","0","0","0","0","0","0","0","0","0","-2"
"110608","California State University-Northridge","2019","First major","'14'","Engineering","Bachelor's degree","457","399","58","0","0","0","55","47","8","12","8","4","140","129","11","0","0","0","89","77","12","9","7","2","19","17","2","133","114","19","-2"
"110608","California State University-Northridge","2019","First major","'14'","Engineering","Master's degree","107","91","16","1","1","0","15","14","1","2","2","0","12","11","1","0","0","0","37","28","9","1","1","0","5","3","2","34","31","3","-2"
"110608","California State University-Northridge","2019","Second major","'14'","Engineering","Bachelor's degree","1","1","0","0","0","0","0","0","0","0","0","0","1","1","0","0","0","0","0","0","0","0","0","0","0","0","0","0","0","0","-2"
"110617","California State University-Sacramento","2019","First major","'14'","Engineering","Bachelor's degree","436","363","73","1","1","0","106","92","14","8","6","2","110","91","19","4","4","0","134","109","25","28","25","3","34","26","8","11","9","2","-2"
"110617","California State University-Sacramento","2019","First major","'14'","Engineering","Master's degree","77","55","22","0","0","0","17","13","4","3","1","2","7","5","2","0","0","0","20","18","2","2","1","1","4","2","2","24","15","9","-2"
"110617","California State University-Sacramento","2019","Second major","'14'","Engineering","Bachelor's degree","2","2","0","0","0","0","1","1","0","0","0","0","0","0","0","0","0","0","0","0","0","0","0","0","1","1","0","0","0","0","-2"
"110635","University of California-Berkeley","2019","First major","'14'","Engineering","Bachelor's degree","1012","755","257","1","1","0","492","363","129","9","6","3","78","56","22","0","0","0","206","161","45","45","32","13","46","36","10","135","100","35","-2"
"110635","University of California-Berkeley","2019","First major","'14'","Engineering","Master's degree","822","523","299","1","1","0","130","93","37","7","4","3","28","20","8","3","2","1","128","75","53","7","6","1","17","7","10","501","315","186","-2"
"110635","University of California-Berkeley","2019","First major","'14'","Engineering","Doctor's degree - research/scholarship","176","121","55","0","0","0","24","20","4","1","0","1","11","8","3","0","0","0","63","44","19","2","1","1","11","6","5","64","42","22","-2"
"110635","University of California-Berkeley","2019","Second major","'14'","Engineering","Bachelor's degree","18","15","3","0","0","0","10","8","2","0","0","0","0","0","0","0","0","0","1","1","0","2","2","0","1","1","0","4","3","1","-2"
"110644","University of California-Davis","2019","First major","'14'","Engineering","Bachelor's degree","787","560","227","0","0","0","225","145","80","12","10","2","100","68","32","5","3","2","262","197","65","34","26","8","20","14","6","129","97","32","-2"
"110644","University of California-Davis","2019","First major","'14'","Engineering","Master's degree","186","107","79","0","0","0","24","15","9","2","1","1","16","10","6","0","0","0","60","34","26","5","3","2","9","6","3","70","38","32","-2"
"110644","University of California-Davis","2019","First major","'14'","Engineering","Doctor's degree - research/scholarship","81","54","27","0","0","0","4","3","1","0","0","0","1","1","0","0","0","0","22","14","8","1","0","1","3","1","2","50","35","15","-2"
"110644","University of California-Davis","2019","Second major","'14'","Engineering","Bachelor's degree","60","45","15","0","0","0","15","10","5","1","1","0","7","6","1","1","1","0","20","16","4","3","3","0","0","0","0","13","8","5","-2"
"110653","University of California-Irvine","2019","First major","'14'","Engineering","Bachelor's degree","907","690","217","0","0","0","332","239","93","13","5","8","203","164","39","0","0","0","183","141","42","45","35","10","12","10","2","119","96","23","-2"
"110653","University of California-Irvine","2019","First major","'14'","Engineering","Master's degree","298","205","93","0","0","0","38","25","13","3","1","2","12","9","3","0","0","0","36","26","10","2","2","0","19","15","4","188","127","61","-2"
"110653","University of California-Irvine","2019","First major","'14'","Engineering","Doctor's degree - research/scholarship","99","65","34","0","0","0","16","11","5","1","1","0","1","0","1","0","0","0","26","16","10","0","0","0","11","7","4","44","30","14","-2"
"110653","University of California-Irvine","2019","Second major","'14'","Engineering","Bachelor's degree","37","30","7","0","0","0","8","7","1","0","0","0","9","8","1","0","0","0","9","8","1","4","3","1","0","0","0","7","4","3","-2"
"110662","University of California-Los Angeles","2019","First major","'14'","Engineering","Bachelor's degree","648","502","146","1","1","0","261","210","51","3","3","0","46","34","12","1","1","0","178","136","42","24","20","4","11","9","2","123","88","35","-2"
"110662","University of California-Los Angeles","2019","First major","'14'","Engineering","Master's degree","571","442","129","1","1","0","100","81","19","5","5","0","38","24","14","0","0","0","109","91","18","14","9","5","16","13","3","288","218","70","-2"
"110662","University of California-Los Angeles","2019","First major","'14'","Engineering","Doctor's degree - research/scholarship","134","99","35","2","1","1","17","12","5","2","1","1","6","2","4","0","0","0","20","15","5","0","0","0","0","0","0","87","68","19","-2"
"110671","University of California-Riverside","2019","First major","'14'","Engineering","Bachelor's degree","391","299","92","2","2","0","158","113","45","13","8","5","105","80","25","1","1","0","76","63","13","19","15","4","7","7","0","10","10","0","-2"
"110671","University of California-Riverside","2019","First major","'14'","Engineering","Master's degree","146","113","33","1","1","0","32","25","7","2","2","0","11","9","2","0","0","0","48","39","9","5","4","1","3","2","1","44","31","13","-2"
"110671","University of California-Riverside","2019","First major","'14'","Engineering","Doctor's degree - research/scholarship","58","46","12","1","1","0","10","9","1","2","1","1","4","2","2","0","0","0","13","11","2","1","1","0","4","3","1","23","18","5","-2"
"110680","University of California-San Diego","2019","First major","'14'","Engineering","Bachelor's degree","936","701","235","1","0","1","371","262","109","8","5","3","113","88","25","2","2","0","209","165","44","41","30","11","14","10","4","177","139","38","-2"
"110680","University of California-San Diego","2019","First major","'14'","Engineering","Master's degree","605","462","143","0","0","0","88","74","14","7","7","0","37","28","9","0","0","0","117","88","29","16","13","3","10","9","1","330","243","87","-2"
"110680","University of California-San Diego","2019","First major","'14'","Engineering","Doctor's degree - research/scholarship","147","107","40","0","0","0","12","9","3","2","2","0","5","4","1","0","0","0","29","21","8","3","1","2","5","4","1","91","66","25","-2"
"110680","University of California-San Diego","2019","Second major","'14'","Engineering","Bachelor's degree","2","2","0","0","0","0","0","0","0","0","0","0","0","0","0","0","0","0","0","0","0","0","0","0","0","0","0","2","2","0","-2"
"110699","University of California-San Francisco","2019","First major","'14'","Engineering","Master's degree","18","6","12","0","0","0","5","2","3","0","0","0","0","0","0","0","0","0","7","2","5","1","0","1","1","0","1","4","2","2","-2"
"110699","University of California-San Francisco","2019","First major","'14'","Engineering","Doctor's degree - research/scholarship","18","11","7","0","0","0","4","2","2","0","0","0","1","1","0","0","0","0","5","3","2","1","1","0","2","1","1","5","3","2","-2"
"110705","University of California-Santa Barbara","2019","First major","'14'","Engineering","Bachelor's degree","268","215","53","0","0","0","83","69","14","3","3","0","41","32","9","0","0","0","85","69","16","23","17","6","9","6","3","24","19","5","-2"
"110705","University of California-Santa Barbara","2019","First major","'14'","Engineering","Master's degree","79","65","14","0","0","0","6","6","0","0","0","0","5","4","1","0","0","0","23","19","4","0","0","0","1","0","1","44","36","8","-2"
"110705","University of California-Santa Barbara","2019","First major","'14'","Engineering","Doctor's degree - research/scholarship","46","40","6","0","0","0","3","2","1","0","0","0","1","1","0","0","0","0","18","17","1","0","0","0","0","0","0","24","20","4","-2"
"110714","University of California-Santa Cruz","2019","First major","'14'","Engineering","Bachelor's degree","193","144","49","0","0","0","52","40","12","3","3","0","45","32","13","1","1","0","65","45","20","12","10","2","5","5","0","10","8","2","-2"
"110714","University of California-Santa Cruz","2019","First major","'14'","Engineering","Master's degree","89","70","19","0","0","0","5","4","1","1","1","0","5","3","2","0","0","0","11","11","0","4","3","1","4","3","1","59","45","14","-2"
"110714","University of California-Santa Cruz","2019","First major","'14'","Engineering","Doctor's degree - research/scholarship","15","11","4","0","0","0","1","0","1","1","1","0","1","1","0","0","0","0","4","2","2","2","2","0","1","0","1","5","5","0","-2"
"110714","University of California-Santa Cruz","2019","Second major","'14'","Engineering","Bachelor's degree","3","3","0","0","0","0","1","1","0","0","0","0","0","0","0","0","0","0","1","1","0","0","0","0","0","0","0","1","1","0","-2"
"111188","California State University Maritime Academy","2019","First major","'14'","Engineering","Bachelor's degree","36","31","5","0","0","0","6","5","1","1","1","0","6","5","1","0","0","0","14","13","1","4","3","1","5","4","1","0","0","0","-2"
"111188","California State University Maritime Academy","2019","First major","'14'","Engineering","Master's degree","0","0","0","0","0","0","0","0","0","0","0","0","0","0","0","0","0","0","0","0","0","0","0","0","0","0","0","0","0","0","-2"
"111434","Canada College","2019","First major","'14'","Engineering","Associate's degree","10","9","1","0","0","0","1","1","0","0","0","0","3","2","1","0","0","0","2","2","0","1","1","0","1","1","0","2","2","0","-2"
"111461","College of the Canyons","2019","First major","'14'","Engineering","Associate's degree","10","9","1","0","0","0","1","1","0","0","0","0","7","6","1","0","0","0","2","2","0","0","0","0","0","0","0","0","0","0","-2"
"111887","Cerritos College","2019","First major","'14'","Engineering","Associate's degree","24","18","6","0","0","0","7","4","3","1","1","0","15","12","3","0","0","0","1","1","0","0","0","0","0","0","0","0","0","0","-2"
"111896","Cerro Coso Community College","2019","First major","'14'","Engineering","Associate's degree","2","2","0","0","0","0","0","0","0","0","0","0","0","0","0","0","0","0","2","2","0","0","0","0","0","0","0","0","0","0","-2"
"111920","Chabot College","2019","First major","'14'","Engineering","Associate's degree","8","6","2","0","0","0","1","0","1","0","0","0","6","5","1","0","0","0","1","1","0","0","0","0","0","0","0","0","0","0","-2"
"111939","Chaffey College","2019","First major","'14'","Engineering","Associate's degree","4","2","2","0","0","0","0","0","0","0","0","0","1","0","1","0","0","0","3","2","1","0","0","0","0","0","0","0","0","0","-2"
"111948","Chapman University","2019","First major","'14'","Engineering","Bachelor's degree","8","7","1","0","0","0","0","0","0","0","0","0","1","1","0","0","0","0","6","5","1","0","0","0","0","0","0","1","1","0","-2"
"112172","Citrus College","2019","First major","'14'","Engineering","Associate's degree","6","4","2","0","0","0","1","1","0","0","0","0","4","2","2","0","0","0","1","1","0","0","0","0","0","0","0","0","0","0","-2"
"112190","City College of San Francisco","2019","First major","'14'","Engineering","Associate's degree","7","6","1","0","0","0","2","2","0","0","0","0","2","2","0","0","0","0","2","2","0","1","0","1","0","0","0","0","0","0","-2"
"112260","Claremont McKenna College","2019","First major","'14'","Engineering","Bachelor's degree","7","6","1","0","0","0","0","0","0","0","0","0","0","0","0","0","0","0","2","1","1","1","1","0","0","0","0","4","4","0","-2"
"112686","Compton College","2019","First major","'14'","Engineering","Associate's degree","5","4","1","0","0","0","0","0","0","0","0","0","5","4","1","0","0","0","0","0","0","0","0","0","0","0","0","0","0","0","-2"
"112826","Contra Costa College","2019","First major","'14'","Engineering","Associate's degree","4","4","0","0","0","0","0","0","0","1","1","0","1","1","0","0","0","0","2","2","0","0","0","0","0","0","0","0","0","0","-2"
"113096","Cosumnes River College","2019","First major","'14'","Engineering","Associate's degree","5","5","0","0","0","0","1","1","0","0","0","0","2","2","0","1","1","0","0","0","0","0","0","0","1","1","0","0","0","0","-2"
"113193","Cuesta College","2019","First major","'14'","Engineering","Associate's degree","6","6","0","0","0","0","0","0","0","0","0","0","1","1","0","0","0","0","4","4","0","1","1","0","0","0","0","0","0","0","-2"
"113218","Cuyamaca College","2019","First major","'14'","Engineering","Associate's degree","0","0","0","0","0","0","0","0","0","0","0","0","0","0","0","0","0","0","0","0","0","0","0","0","0","0","0","0","0","0","-2"
"113236","Cypress College","2019","First major","'14'","Engineering","Associate's degree","1","0","1","0","0","0","0","0","0","0","0","0","1","0","1","0","0","0","0","0","0","0","0","0","0","0","0","0","0","0","-2"
"113634","Diablo Valley College","2019","First major","'14'","Engineering","Associate's degree","19","16","3","0","0","0","0","0","0","0","0","0","1","1","0","0","0","0","16","14","2","1","1","0","0","0","0","1","0","1","-2"
"113980","El Camino Community College District","2019","First major","'14'","Engineering","Associate's degree","22","15","7","0","0","0","3","1","2","2","1","1","10","9","1","0","0","0","7","4","3","0","0","0","0","0","0","0","0","0","-2"
"114266","Evergreen Valley College","2019","First major","'14'","Engineering","Associate's degree","3","2","1","0","0","0","2","2","0","0","0","0","1","0","1","0","0","0","0","0","0","0","0","0","0","0","0","0","0","0","-2"
"114716","Foothill College","2019","First major","'14'","Engineering","Associate's degree","3","3","0","0","0","0","2","2","0","0","0","0","0","0","0","0","0","0","1","1","0","0","0","0","0","0","0","0","0","0","-2"
"114789","Fresno City College","2019","First major","'14'","Engineering","Associate's degree","1","1","0","0","0","0","0","0","0","0","0","0","0","0","0","0","0","0","1","1","0","0","0","0","0","0","0","0","0","0","-2"
"114859","Fullerton College","2019","First major","'14'","Engineering","Associate's degree","17","12","5","0","0","0","4","2","2","0","0","0","9","7","2","0","0","0","0","0","0","1","1","0","0","0","0","3","2","1","-2"
"114938","Gavilan College","2019","First major","'14'","Engineering","Associate's degree","0","0","0","0","0","0","0","0","0","0","0","0","0","0","0","0","0","0","0","0","0","0","0","0","0","0","0","0","0","0","-2"
"115393","Hartnell College","2019","First major","'14'","Engineering","Associate's degree","8","6","2","0","0","0","0","0","0","0","0","0","8","6","2","0","0","0","0","0","0","0","0","0","0","0","0","0","0","0","-2"
"115409","Harvey Mudd College","2019","First major","'14'","Engineering","Bachelor's degree","83","47","36","0","0","0","17","7","10","2","1","1","17","10","7","1","1","0","29","15","14","8","6","2","1","0","1","8","7","1","-2"
"115755","Humboldt State University","2019","First major","'14'","Engineering","Bachelor's degree","50","35","15","0","0","0","1","0","1","3","2","1","11","5","6","0","0","0","27","22","5","2","1","1","6","5","1","0","0","0","-2"
"115861","Imperial Valley College","2019","First major","'14'","Engineering","Associate's degree","5","5","0","0","0","0","0","0","0","0","0","0","5","5","0","0","0","0","0","0","0","0","0","0","0","0","0","0","0","0","-2"
"117052","Reedley College","2019","First major","'14'","Engineering","Associate's degree","7","7","0","0","0","0","0","0","0","0","0","0","6","6","0","0","0","0","1","1","0","0","0","0","0","0","0","0","0","0","-2"
"117645","Long Beach City College","2019","First major","'14'","Engineering","Associate's degree","1","1","0","0","0","0","0","0","0","0","0","0","1","1","0","0","0","0","0","0","0","0","0","0","0","0","0","0","0","0","-2"
"117690","Los Angeles Harbor College","2019","First major","'14'","Engineering","Associate's degree","0","0","0","0","0","0","0","0","0","0","0","0","0","0","0","0","0","0","0","0","0","0","0","0","0","0","0","0","0","0","-2"
"117706","Los Angeles Pierce College","2019","First major","'14'","Engineering","Associate's degree","4","3","1","0","0","0","2","2","0","0","0","0","0","0","0","0","0","0","0","0","0","0","0","0","1","1","0","1","0","1","-2"
"117724","Los Angeles Trade Technical College","2019","First major","'14'","Engineering","Associate's degree","2","1","1","1","0","1","0","0","0","0","0","0","1","1","0","0","0","0","0","0","0","0","0","0","0","0","0","0","0","0","-2"
"117733","Los Angeles Valley College","2019","First major","'14'","Engineering","Associate's degree","1","1","0","0","0","0","0","0","0","0","0","0","1","1","0","0","0","0","0","0","0","0","0","0","0","0","0","0","0","0","-2"
"117751","The Master's University and Seminary","2019","First major","'14'","Engineering","Bachelor's degree","0","0","0","0","0","0","0","0","0","0","0","0","0","0","0","0","0","0","0","0","0","0","0","0","0","0","0","0","0","0","-2"
"117788","Los Angeles City College","2019","First major","'14'","Engineering","Associate's degree","3","2","1","0","0","0","1","1","0","0","0","0","2","1","1","0","0","0","0","0","0","0","0","0","0","0","0","0","0","0","-2"
"117894","Los Medanos College","2019","First major","'14'","Engineering","Associate's degree","4","4","0","0","0","0","0","0","0","0","0","0","3","3","0","0","0","0","1","1","0","0","0","0","0","0","0","0","0","0","-2"
"117946","Loyola Marymount University","2019","First major","'14'","Engineering","Bachelor's degree","76","61","15","0","0","0","6","6","0","2","1","1","16","12","4","0","0","0","32","27","5","12","8","4","0","0","0","8","7","1","-2"
"117946","Loyola Marymount University","2019","First major","'14'","Engineering","Master's degree","44","26","18","0","0","0","9","6","3","4","3","1","8","3","5","0","0","0","12","8","4","3","1","2","0","0","0","8","5","3","-2"
"117946","Loyola Marymount University","2019","Second major","'14'","Engineering","Bachelor's degree","1","1","0","0","0","0","0","0","0","0","0","0","0","0","0","0","0","0","0","0","0","0","0","0","0","0","0","1","1","0","-2"
"118347","College of Marin","2019","First major","'14'","Engineering","Associate's degree","0","0","0","0","0","0","0","0","0","0","0","0","0","0","0","0","0","0","0","0","0","0","0","0","0","0","0","0","0","0","-2"
"118718","Merced College","2019","First major","'14'","Engineering","Associate's degree","1","0","1","0","0","0","0","0","0","0","0","0","0","0","0","0","0","0","1","0","1","0","0","0","0","0","0","0","0","0","-2"
"118930","Mission College","2019","First major","'14'","Engineering","Associate's degree","10","8","2","0","0","0","5","4","1","0","0","0","1","1","0","0","0","0","2","1","1","0","0","0","0","0","0","2","2","0","-2"
"119067","Monterey Peninsula College","2019","First major","'14'","Engineering","Associate's degree","5","5","0","0","0","0","2","2","0","0","0","0","1","1","0","0","0","0","2","2","0","0","0","0","0","0","0","0","0","0","-2"
"119137","Moorpark College","2019","First major","'14'","Engineering","Associate's degree","13","12","1","0","0","0","2","1","1","0","0","0","4","4","0","0","0","0","5","5","0","1","1","0","0","0","0","1","1","0","-2"
"119605","National University","2019","First major","'14'","Engineering","Bachelor's degree","41","37","4","0","0","0","8","7","1","3","2","1","7","6","1","0","0","0","15","15","0","4","3","1","3","3","0","1","1","0","-2"
"119678","Naval Postgraduate School","2019","First major","'14'","Engineering","Master's degree","382","309","73","0","0","0","25","19","6","18","15","3","32","26","6","0","0","0","244","193","51","0","0","0","36","31","5","27","25","2","-2"
"119678","Naval Postgraduate School","2019","First major","'14'","Engineering","Doctor's degree - research/scholarship","4","3","1","0","0","0","0","0","0","0","0","0","0","0","0","0","0","0","3","3","0","0","0","0","0","0","0","1","0","1","-2"
"120166","Northwestern Polytechnic University","2019","First major","'14'","Engineering","Master's degree","0","0","0","0","0","0","0","0","0","0","0","0","0","0","0","0","0","0","0","0","0","0","0","0","0","0","0","0","0","0","-2"
"120290","Ohlone College","2019","First major","'14'","Engineering","Associate's degree","1","1","0","0","0","0","0","0","0","0","0","0","0","0","0","0","0","0","1","1","0","0","0","0","0","0","0","0","0","0","-2"
"120342","Orange Coast College","2019","First major","'14'","Engineering","Associate's degree","60","52","8","0","0","0","25","22","3","0","0","0","11","11","0","0","0","0","19","17","2","0","0","0","0","0","0","5","2","3","-2"
"120865","Pacific Union College","2019","First major","'14'","Engineering","Associate's degree","0","0","0","0","0","0","0","0","0","0","0","0","0","0","0","0","0","0","0","0","0","0","0","0","0","0","0","0","0","0","-2"
"120883","University of the Pacific","2019","First major","'14'","Engineering","Bachelor's degree","73","56","17","3","3","0","20","13","7","1","0","1","14","11","3","0","0","0","24","19","5","2","2","0","4","3","1","5","5","0","-2"
"120883","University of the Pacific","2019","First major","'14'","Engineering","Master's degree","27","24","3","0","0","0","10","8","2","1","1","0","2","1","1","0","0","0","10","10","0","2","2","0","2","2","0","0","0","0","-2"
"120971","Palomar College","2019","First major","'14'","Engineering","Associate's degree","7","6","1","0","0","0","1","1","0","0","0","0","0","0","0","0","0","0","5","5","0","1","0","1","0","0","0","0","0","0","-2"
"121257","Pitzer College","2019","First major","'14'","Engineering","Bachelor's degree","0","0","0","0","0","0","0","0","0","0","0","0","0","0","0","0","0","0","0","0","0","0","0","0","0","0","0","0","0","0","-2"
"121257","Pitzer College","2019","Second major","'14'","Engineering","Bachelor's degree","1","0","1","0","0","0","0","0","0","0","0","0","1","0","1","0","0","0","0","0","0","0","0","0","0","0","0","0","0","0","-2"
"121309","Point Loma Nazarene University","2019","First major","'14'","Engineering","Bachelor's degree","21","19","2","0","0","0","5","4","1","1","1","0","5","5","0","1","1","0","5","5","0","4","3","1","0","0","0","0","0","0","-2"
"121345","Pomona College","2019","First major","'14'","Engineering","Bachelor's degree","1","1","0","0","0","0","0","0","0","0","0","0","0","0","0","0","0","0","0","0","0","0","0","0","0","0","0","1","1","0","-2"
"121345","Pomona College","2019","Second major","'14'","Engineering","Bachelor's degree","1","1","0","0","0","0","0","0","0","0","0","0","0","0","0","0","0","0","1","1","0","0","0","0","0","0","0","0","0","0","-2"
"121619","Santa Ana College","2019","First major","'14'","Engineering","Associate's degree","3","3","0","0","0","0","0","0","0","0","0","0","3","3","0","0","0","0","0","0","0","0","0","0","0","0","0","0","0","0","-2"
"121886","Rio Hondo College","2019","First major","'14'","Engineering","Associate's degree","9","5","4","0","0","0","1","0","1","0","0","0","8","5","3","0","0","0","0","0","0","0","0","0","0","0","0","0","0","0","-2"
"122180","Sacramento City College","2019","First major","'14'","Engineering","Associate's degree","15","11","4","0","0","0","6","3","3","1","1","0","6","5","1","0","0","0","0","0","0","2","2","0","0","0","0","0","0","0","-2"
"122205","Saddleback College","2019","First major","'14'","Engineering","Associate's degree","8","7","1","0","0","0","2","2","0","0","0","0","1","1","0","0","0","0","5","4","1","0","0","0","0","0","0","0","0","0","-2"
"122339","San Diego City College","2019","First major","'14'","Engineering","Associate's degree","21","17","4","1","1","0","2","1","1","2","2","0","12","9","3","0","0","0","3","3","0","0","0","0","0","0","0","1","1","0","-2"
"122375","San Diego Mesa College","2019","First major","'14'","Engineering","Associate's degree","18","17","1","0","0","0","2","2","0","0","0","0","5","5","0","0","0","0","8","8","0","2","2","0","1","0","1","0","0","0","-2"
"122384","San Diego Miramar College","2019","First major","'14'","Engineering","Associate's degree","28","25","3","0","0","0","16","15","1","1","1","0","3","1","2","0","0","0","6","6","0","2","2","0","0","0","0","0","0","0","-2"
"122409","San Diego State University","2019","First major","'14'","Engineering","Bachelor's degree","714","585","129","1","1","0","91","70","21","16","13","3","172","142","30","3","2","1","233","192","41","45","39","6","25","21","4","128","105","23","-2"
"122409","San Diego State University","2019","First major","'14'","Engineering","Master's degree","97","64","33","1","0","1","9","5","4","1","0","1","10","9","1","0","0","0","26","22","4","5","4","1","4","3","1","41","21","20","-2"
"122409","San Diego State University","2019","First major","'14'","Engineering","Doctor's degree - research/scholarship","2","0","2","0","0","0","0","0","0","0","0","0","0","0","0","0","0","0","1","0","1","1","0","1","0","0","0","0","0","0","-2"
"122409","San Diego State University","2019","Second major","'14'","Engineering","Bachelor's degree","4","4","0","0","0","0","1","1","0","0","0","0","0","0","0","0","0","0","2","2","0","0","0","0","0","0","0","1","1","0","-2"
"122436","University of San Diego","2019","First major","'14'","Engineering","Bachelor's degree","126","88","38","0","0","0","7","5","2","5","3","2","18","9","9","0","0","0","58","43","15","6","2","4","5","4","1","27","22","5","-2"
"122597","San Francisco State University","2019","First major","'14'","Engineering","Bachelor's degree","232","188","44","0","0","0","79","64","15","8","6","2","55","44","11","1","1","0","33","27","6","8","8","0","11","8","3","37","30","7","-2"
"122597","San Francisco State University","2019","First major","'14'","Engineering","Master's degree","40","28","12","0","0","0","5","5","0","0","0","0","2","2","0","0","0","0","2","1","1","3","3","0","1","0","1","27","17","10","-2"
"122597","San Francisco State University","2019","Second major","'14'","Engineering","Bachelor's degree","1","1","0","0","0","0","1","1","0","0","0","0","0","0","0","0","0","0","0","0","0","0","0","0","0","0","0","0","0","0","-2"
"122658","San Joaquin Delta College","2019","First major","'14'","Engineering","Associate's degree","4","3","1","0","0","0","0","0","0","0","0","0","2","1","1","0","0","0","2","2","0","0","0","0","0","0","0","0","0","0","-2"
"122755","San Jose State University","2019","First major","'14'","Engineering","Bachelor's degree","980","784","196","0","0","0","425","325","100","20","14","6","184","155","29","5","2","3","178","149","29","49","47","2","37","29","8","82","63","19","-2"
"122755","San Jose State University","2019","First major","'14'","Engineering","Master's degree","963","647","316","0","0","0","197","103","94","7","6","1","24","21","3","1","1","0","61","50","11","9","7","2","28","24","4","636","435","201","-2"
"122755","San Jose State University","2019","Second major","'14'","Engineering","Master's degree","1","1","0","0","0","0","0","0","0","1","1","0","0","0","0","0","0","0","0","0","0","0","0","0","0","0","0","0","0","0","-2"
"122791","College of San Mateo","2019","First major","'14'","Engineering","Associate's degree","2","2","0","0","0","0","1","1","0","0","0","0","0","0","0","0","0","0","0","0","0","0","0","0","0","0","0","1","1","0","-2"
"122889","Santa Barbara City College","2019","First major","'14'","Engineering","Associate's degree","31","24","7","0","0","0","2","2","0","0","0","0","9","8","1","0","0","0","13","10","3","4","4","0","1","0","1","2","0","2","-2"
"122931","Santa Clara University","2019","First major","'14'","Engineering","Bachelor's degree","199","142","57","1","0","1","36","19","17","2","2","0","28","22","6","0","0","0","101","74","27","16","13","3","5","5","0","10","7","3","-2"
"122931","Santa Clara University","2019","First major","'14'","Engineering","Master's degree","317","197","120","0","0","0","40","30","10","4","2","2","16","14","2","0","0","0","42","35","7","11","6","5","2","2","0","202","108","94","-2"
"122931","Santa Clara University","2019","First major","'14'","Engineering","Doctor's degree - research/scholarship","7","6","1","0","0","0","3","3","0","0","0","0","0","0","0","0","0","0","3","2","1","0","0","0","0","0","0","1","1","0","-2"
"122931","Santa Clara University","2019","First major","'14'","Engineering","Doctor's degree - professional practice","0","0","0","0","0","0","0","0","0","0","0","0","0","0","0","0","0","0","0","0","0","0","0","0","0","0","0","0","0","0","-2"
"122931","Santa Clara University","2019","Second major","'14'","Engineering","Bachelor's degree","3","3","0","0","0","0","0","0","0","0","0","0","0","0","0","0","0","0","1","1","0","1","1","0","1","1","0","0","0","0","-2"
"123013","Santa Rosa Junior College","2019","First major","'14'","Engineering","Associate's degree","24","24","0","0","0","0","4","4","0","1","1","0","6","6","0","0","0","0","11","11","0","1","1","0","1","1","0","0","0","0","-2"
"123165","Scripps College","2019","First major","'14'","Engineering","Bachelor's degree","1","0","1","0","0","0","0","0","0","0","0","0","0","0","0","0","0","0","1","0","1","0","0","0","0","0","0","0","0","0","-2"
"123217","College of the Sequoias","2019","First major","'14'","Engineering","Associate's degree","9","7","2","0","0","0","0","0","0","0","0","0","6","4","2","0","0","0","2","2","0","1","1","0","0","0","0","0","0","0","-2"
"123299","Shasta College","2019","First major","'14'","Engineering","Associate's degree","8","7","1","0","0","0","0","0","0","0","0","0","2","2","0","0","0","0","3","2","1","1","1","0","2","2","0","0","0","0","-2"
"123341","Sierra College","2019","First major","'14'","Engineering","Associate's degree","10","9","1","0","0","0","1","1","0","0","0","0","4","4","0","0","0","0","3","3","0","0","0","0","2","1","1","0","0","0","-2"
"123509","Skyline College","2019","First major","'14'","Engineering","Associate's degree","3","3","0","0","0","0","2","2","0","0","0","0","0","0","0","0","0","0","1","1","0","0","0","0","0","0","0","0","0","0","-2"
"123527","San Bernardino Valley College","2019","First major","'14'","Engineering","Associate's degree","1","1","0","0","0","0","0","0","0","0","0","0","1","1","0","0","0","0","0","0","0","0","0","0","0","0","0","0","0","0","-2"
"123554","Saint Mary's College of California","2019","First major","'14'","Engineering","Bachelor's degree","5","4","1","0","0","0","1","1","0","0","0","0","2","2","0","0","0","0","1","1","0","1","0","1","0","0","0","0","0","0","-2"
"123563","Solano Community College","2019","First major","'14'","Engineering","Associate's degree","5","4","1","0","0","0","1","1","0","1","1","0","0","0","0","0","0","0","1","1","0","2","1","1","0","0","0","0","0","0","-2"
"123572","Sonoma State University","2019","First major","'14'","Engineering","Bachelor's degree","20","15","5","0","0","0","3","3","0","0","0","0","4","4","0","0","0","0","8","5","3","2","1","1","3","2","1","0","0","0","-2"
"123572","Sonoma State University","2019","First major","'14'","Engineering","Master's degree","2","1","1","0","0","0","0","0","0","0","0","0","0","0","0","0","0","0","0","0","0","0","0","0","1","0","1","1","1","0","-2"
"123800","Southwestern College","2019","First major","'14'","Engineering","Associate's degree","0","0","0","0","0","0","0","0","0","0","0","0","0","0","0","0","0","0","0","0","0","0","0","0","0","0","0","0","0","0","-2"
"123961","University of Southern California","2019","First major","'14'","Engineering","Bachelor's degree","445","303","142","0","0","0","105","66","39","10","7","3","59","42","17","1","1","0","165","108","57","21","16","5","9","5","4","75","58","17","-2"
"123961","University of Southern California","2019","First major","'14'","Engineering","Master's degree","1285","895","390","2","2","0","99","68","31","9","6","3","54","39","15","0","0","0","166","120","46","13","10","3","10","8","2","932","642","290","-2"
"123961","University of Southern California","2019","First major","'14'","Engineering","Doctor's degree - research/scholarship","125","89","36","0","0","0","15","10","5","0","0","0","2","2","0","0","0","0","25","17","8","0","0","0","2","2","0","81","58","23","-2"
"123961","University of Southern California","2019","First major","'14'","Engineering","Doctor's degree - other","1","1","0","0","0","0","0","0","0","0","0","0","0","0","0","0","0","0","0","0","0","0","0","0","0","0","0","1","1","0","-2"
"124113","Taft College","2019","First major","'14'","Engineering","Associate's degree","3","3","0","0","0","0","0","0","0","0","0","0","3","3","0","0","0","0","0","0","0","0","0","0","0","0","0","0","0","0","-2"
"125028","Ventura College","2019","First major","'14'","Engineering","Associate's degree","28","23","5","0","0","0","1","0","1","1","1","0","20","17","3","0","0","0","6","5","1","0","0","0","0","0","0","0","0","0","-2"
"125499","West Valley College","2019","First major","'14'","Engineering","Associate's degree","2","2","0","0","0","0","1","1","0","0","0","0","0","0","0","0","0","0","1","1","0","0","0","0","0","0","0","0","0","0","-2"
"125727","Westmont College","2019","First major","'14'","Engineering","Bachelor's degree","4","3","1","0","0","0","0","0","0","0","0","0","0","0","0","0","0","0","3","2","1","0","0","0","1","1","0","0","0","0","-2"
"125763","Whittier College","2019","First major","'14'","Engineering","Bachelor's degree","0","0","0","0","0","0","0","0","0","0","0","0","0","0","0","0","0","0","0","0","0","0","0","0","0","0","0","0","0","0","-2"
"126562","University of Colorado Denver/Anschutz Medical Campus","2019","First major","'14'","Engineering","Bachelor's degree","179","153","26","1","1","0","19","13","6","5","4","1","28","25","3","0","0","0","100","85","15","6","6","0","6","5","1","14","14","0","-2"
"126562","University of Colorado Denver/Anschutz Medical Campus","2019","First major","'14'","Engineering","Master's degree","92","69","23","0","0","0","1","0","1","3","3","0","7","6","1","0","0","0","46","33","13","1","1","0","2","2","0","32","24","8","-2"
"126562","University of Colorado Denver/Anschutz Medical Campus","2019","First major","'14'","Engineering","Doctor's degree - research/scholarship","16","11","5","0","0","0","3","2","1","0","0","0","1","0","1","0","0","0","4","3","1","1","0","1","0","0","0","7","6","1","-2"
"126580","University of Colorado Colorado Springs","2019","First major","'14'","Engineering","Bachelor's degree","147","130","17","0","0","0","6","5","1","3","3","0","22","21","1","0","0","0","95","83","12","12","9","3","0","0","0","9","9","0","-2"
"126580","University of Colorado Colorado Springs","2019","First major","'14'","Engineering","Master's degree","45","34","11","0","0","0","4","3","1","0","0","0","4","3","1","0","0","0","22","17","5","6","5","1","2","2","0","7","4","3","-2"
"126580","University of Colorado Colorado Springs","2019","First major","'14'","Engineering","Doctor's degree - research/scholarship","15","11","4","0","0","0","2","0","2","0","0","0","0","0","0","0","0","0","3","2","1","0","0","0","1","0","1","9","9","0","-2"
"126580","University of Colorado Colorado Springs","2019","Second major","'14'","Engineering","Bachelor's degree","1","1","0","0","0","0","0","0","0","0","0","0","0","0","0","0","0","0","1","1","0","0","0","0","0","0","0","0","0","0","-2"
"126614","University of Colorado Boulder","2019","First major","'14'","Engineering","Bachelor's degree","827","620","207","4","4","0","55","39","16","4","3","1","96","78","18","0","0","0","517","389","128","34","20","14","11","6","5","106","81","25","-2"
"126614","University of Colorado Boulder","2019","First major","'14'","Engineering","Master's degree","536","384","152","0","0","0","22","13","9","3","2","1","29","21","8","1","0","1","254","187","67","17","9","8","16","10","6","194","142","52","-2"
"126614","University of Colorado Boulder","2019","First major","'14'","Engineering","Doctor's degree - research/scholarship","106","79","27","1","1","0","1","1","0","1","1","0","0","0","0","0","0","0","47","31","16","2","1","1","9","7","2","45","37","8","-2"
"126775","Colorado School of Mines","2019","First major","'14'","Engineering","Bachelor's degree","945","664","281","2","1","1","37","21","16","12","9","3","56","41","15","1","1","0","699","505","194","63","36","27","6","6","0","69","44","25","-2"
"126775","Colorado School of Mines","2019","First major","'14'","Engineering","Master's degree","226","162","64","0","0","0","6","4","2","0","0","0","26","18","8","0","0","0","123","85","38","8","6","2","1","1","0","62","48","14","-2"
"126775","Colorado School of Mines","2019","First major","'14'","Engineering","Doctor's degree - research/scholarship","53","35","18","0","0","0","1","0","1","0","0","0","4","3","1","0","0","0","19","14","5","0","0","0","0","0","0","29","18","11","-2"
"126818","Colorado State University-Fort Collins","2019","First major","'14'","Engineering","Bachelor's degree","516","407","109","3","2","1","11","3","8","9","8","1","35","26","9","0","0","0","368","295","73","14","10","4","13","10","3","63","53","10","-2"
"126818","Colorado State University-Fort Collins","2019","First major","'14'","Engineering","Master's degree","191","141","50","1","1","0","3","1","2","1","0","1","9","9","0","0","0","0","84","61","23","1","0","1","3","2","1","89","67","22","-2"
"126818","Colorado State University-Fort Collins","2019","First major","'14'","Engineering","Doctor's degree - research/scholarship","52","38","14","0","0","0","2","2","0","1","1","0","1","1","0","0","0","0","21","15","6","0","0","0","2","2","0","25","17","8","-2"
"126818","Colorado State University-Fort Collins","2019","Second major","'14'","Engineering","Bachelor's degree","54","31","23","1","0","1","4","1","3","0","0","0","3","2","1","0","0","0","42","25","17","1","1","0","2","1","1","1","1","0","-2"
"126818","Colorado State University-Fort Collins","2019","Second major","'14'","Engineering","Master's degree","2","1","1","0","0","0","0","0","0","0","0","0","0","0","0","0","0","0","2","1","1","0","0","0","0","0","0","0","0","0","-2"
"126827","Colorado Technical University-Colorado Springs","2019","First major","'14'","Engineering","Bachelor's degree","14","13","1","0","0","0","0","0","0","1","1","0","0","0","0","0","0","0","12","11","1","0","0","0","1","1","0","0","0","0","-2"
"126827","Colorado Technical University-Colorado Springs","2019","First major","'14'","Engineering","Master's degree","14","12","2","0","0","0","2","1","1","1","1","0","0","0","0","0","0","0","6","6","0","1","1","0","4","3","1","0","0","0","-2"
"127060","University of Denver","2019","First major","'14'","Engineering","Bachelor's degree","51","42","9","0","0","0","3","3","0","0","0","0","8","7","1","0","0","0","31","23","8","3","3","0","1","1","0","5","5","0","-2"
"127060","University of Denver","2019","First major","'14'","Engineering","Master's degree","41","34","7","1","1","0","2","2","0","0","0","0","3","3","0","0","0","0","17","13","4","0","0","0","3","3","0","15","12","3","-2"
"127060","University of Denver","2019","First major","'14'","Engineering","Doctor's degree - research/scholarship","13","13","0","0","0","0","0","0","0","0","0","0","0","0","0","0","0","0","3","3","0","0","0","0","0","0","0","10","10","0","-2"
"127185","Fort Lewis College","2019","First major","'14'","Engineering","Bachelor's degree","30","22","8","7","5","2","0","0","0","1","1","0","6","4","2","0","0","0","12","9","3","2","1","1","2","2","0","0","0","0","-2"
"127565","Metropolitan State University of Denver","2019","First major","'14'","Engineering","Bachelor's degree","2","1","1","0","0","0","0","0","0","0","0","0","0","0","0","0","0","0","1","1","0","0","0","0","1","0","1","0","0","0","-2"
"127741","University of Northern Colorado","2019","First major","'14'","Engineering","Bachelor's degree","28","28","0","0","0","0","0","0","0","2","2","0","4","4","0","0","0","0","16","16","0","2","2","0","4","4","0","0","0","0","-2"
"128106","Colorado State University Pueblo","2019","First major","'14'","Engineering","Bachelor's degree","27","20","7","0","0","0","0","0","0","1","1","0","8","6","2","0","0","0","14","11","3","1","1","0","1","0","1","2","1","1","-2"
"128106","Colorado State University Pueblo","2019","First major","'14'","Engineering","Master's degree","7","5","2","0","0","0","0","0","0","0","0","0","1","1","0","0","0","0","1","1","0","1","0","1","1","1","0","3","2","1","-2"
"128328","United States Air Force Academy","2019","First major","'14'","Engineering","Bachelor's degree","255","208","47","0","0","0","12","6","6","5","2","3","25","21","4","2","2","0","169","143","26","25","19","6","10","8","2","7","7","0","-2"
"128577","Asnuntuck Community College","2019","First major","'14'","Engineering","Associate's degree","0","0","0","0","0","0","0","0","0","0","0","0","0","0","0","0","0","0","0","0","0","0","0","0","0","0","0","0","0","0","-2"
"128744","University of Bridgeport","2019","First major","'14'","Engineering","Bachelor's degree","34","30","4","0","0","0","1","0","1","1","1","0","1","1","0","0","0","0","1","0","1","0","0","0","0","0","0","30","28","2","-2"
"128744","University of Bridgeport","2019","First major","'14'","Engineering","Master's degree","89","71","18","0","0","0","12","10","2","1","1","0","0","0","0","0","0","0","7","5","2","0","0","0","0","0","0","69","55","14","-2"
"128744","University of Bridgeport","2019","First major","'14'","Engineering","Doctor's degree - research/scholarship","13","9","4","0","0","0","3","3","0","0","0","0","0","0","0","0","0","0","1","1","0","0","0","0","0","0","0","9","5","4","-2"
"128771","Central Connecticut State University","2019","First major","'14'","Engineering","Bachelor's degree","76","67","9","0","0","0","12","9","3","2","1","1","9","7","2","1","1","0","48","46","2","1","1","0","1","1","0","2","1","1","-2"
"128771","Central Connecticut State University","2019","First major","'14'","Engineering","Master's degree","4","2","2","0","0","0","0","0","0","0","0","0","0","0","0","0","0","0","4","2","2","0","0","0","0","0","0","0","0","0","-2"
"128902","Connecticut College","2019","First major","'14'","Engineering","Bachelor's degree","0","0","0","0","0","0","0","0","0","0","0","0","0","0","0","0","0","0","0","0","0","0","0","0","0","0","0","0","0","0","-2"
"129020","University of Connecticut","2019","First major","'14'","Engineering","Bachelor's degree","701","535","166","1","0","1","103","75","28","17","12","5","43","33","10","0","0","0","459","349","110","25","22","3","29","25","4","24","19","5","129020"
"129020","University of Connecticut","2019","First major","'14'","Engineering","Master's degree","142","100","42","0","0","0","7","4","3","5","4","1","6","5","1","0","0","0","68","48","20","1","1","0","7","4","3","48","34","14","129020"
"129020","University of Connecticut","2019","First major","'14'","Engineering","Doctor's degree - research/scholarship","92","62","30","0","0","0","5","1","4","0","0","0","2","0","2","0","0","0","16","11","5","0","0","0","4","3","1","65","47","18","129020"
"129020","University of Connecticut","2019","Second major","'14'","Engineering","Bachelor's degree","15","10","5","0","0","0","2","1","1","0","0","0","2","2","0","0","0","0","9","5","4","0","0","0","1","1","0","1","1","0","129020"
"129242","Fairfield University","2019","First major","'14'","Engineering","Bachelor's degree","65","53","12","0","0","0","2","2","0","3","2","1","10","9","1","0","0","0","45","37","8","0","0","0","2","1","1","3","2","1","-2"
"129242","Fairfield University","2019","First major","'14'","Engineering","Master's degree","52","39","13","0","0","0","2","1","1","4","3","1","0","0","0","0","0","0","23","20","3","0","0","0","1","1","0","22","14","8","-2"
"129367","Capital Community College","2019","First major","'14'","Engineering","Associate's degree","0","0","0","0","0","0","0","0","0","0","0","0","0","0","0","0","0","0","0","0","0","0","0","0","0","0","0","0","0","0","-2"
"129428","Rensselaer at Hartford","2019","First major","'14'","Engineering","Master's degree","24","22","2","0","0","0","0","0","0","1","1","0","0","0","0","0","0","0","23","21","2","0","0","0","0","0","0","0","0","0","-2"
"129525","University of Hartford","2019","First major","'14'","Engineering","Bachelor's degree","146","122","24","0","0","0","2","2","0","12","10","2","13","8","5","0","0","0","73","58","15","5","4","1","2","2","0","39","38","1","-2"
"129525","University of Hartford","2019","First major","'14'","Engineering","Master's degree","36","32","4","0","0","0","4","4","0","3","3","0","1","1","0","0","0","0","15","13","2","0","0","0","0","0","0","13","11","2","-2"
"129543","Housatonic Community College","2019","First major","'14'","Engineering","Associate's degree","6","4","2","0","0","0","0","0","0","0","0","0","2","1","1","0","0","0","4","3","1","0","0","0","0","0","0","0","0","0","-2"
"129695","Manchester Community College","2019","First major","'14'","Engineering","Associate's degree","33","24","9","0","0","0","2","2","0","3","3","0","4","3","1","0","0","0","23","15","8","0","0","0","1","1","0","0","0","0","-2"
"129729","Naugatuck Valley Community College","2019","First major","'14'","Engineering","Associate's degree","3","3","0","0","0","0","0","0","0","1","1","0","1","1","0","0","0","0","1","1","0","0","0","0","0","0","0","0","0","0","-2"
"129756","Middlesex Community College","2019","First major","'14'","Engineering","Associate's degree","7","6","1","0","0","0","0","0","0","0","0","0","1","1","0","0","0","0","5","4","1","0","0","0","1","1","0","0","0","0","-2"
"129808","Three Rivers Community College","2019","First major","'14'","Engineering","Associate's degree","4","4","0","0","0","0","0","0","0","1","1","0","0","0","0","0","0","0","2","2","0","0","0","0","1","1","0","0","0","0","-2"
"129941","University of New Haven","2019","First major","'14'","Engineering","Bachelor's degree","124","107","17","0","0","0","7","6","1","4","2","2","10","8","2","0","0","0","67","58","9","0","0","0","4","4","0","32","29","3","-2"
"129941","University of New Haven","2019","First major","'14'","Engineering","Master's degree","122","96","26","0","0","0","5","4","1","3","1","2","1","0","1","0","0","0","15","14","1","0","0","0","4","2","2","94","75","19","-2"
"130004","Norwalk Community College","2019","First major","'14'","Engineering","Associate's degree","14","7","7","0","0","0","0","0","0","3","0","3","4","3","1","0","0","0","7","4","3","0","0","0","0","0","0","0","0","0","-2"
"130040","Northwestern Connecticut Community College","2019","First major","'14'","Engineering","Associate's degree","4","4","0","0","0","0","0","0","0","0","0","0","0","0","0","0","0","0","2","2","0","1","1","0","1","1","0","0","0","0","-2"
"130217","Quinebaug Valley Community College","2019","First major","'14'","Engineering","Associate's degree","8","7","1","0","0","0","0","0","0","0","0","0","0","0","0","0","0","0","8","7","1","0","0","0","0","0","0","0","0","0","-2"
"130226","Quinnipiac University","2019","First major","'14'","Engineering","Bachelor's degree","36","28","8","0","0","0","2","1","1","4","3","1","4","4","0","0","0","0","22","17","5","1","1","0","2","2","0","1","0","1","-2"
"130396","Gateway Community College","2019","First major","'14'","Engineering","Associate's degree","14","11","3","0","0","0","0","0","0","4","4","0","2","1","1","0","0","0","7","5","2","0","0","0","0","0","0","1","1","0","-2"
"130590","Trinity College","2019","First major","'14'","Engineering","Bachelor's degree","16","10","6","0","0","0","1","0","1","0","0","0","3","2","1","0","0","0","5","3","2","1","0","1","1","1","0","5","4","1","-2"
"130606","Tunxis Community College","2019","First major","'14'","Engineering","Associate's degree","12","10","2","0","0","0","1","0","1","0","0","0","0","0","0","0","0","0","11","10","1","0","0","0","0","0","0","0","0","0","-2"
"130624","United States Coast Guard Academy","2019","First major","'14'","Engineering","Bachelor's degree","122","95","27","0","0","0","11","9","2","4","3","1","10","9","1","0","0","0","87","65","22","10","9","1","0","0","0","0","0","0","-2"
"130794","Yale University","2019","First major","'14'","Engineering","Bachelor's degree","102","56","46","1","0","1","20","9","11","2","2","0","12","9","3","0","0","0","46","24","22","11","5","6","1","1","0","9","6","3","-2"
"130794","Yale University","2019","First major","'14'","Engineering","Master's degree","164","102","62","0","0","0","18","9","9","1","1","0","1","0","1","2","0","2","60","35","25","4","2","2","1","0","1","77","55","22","-2"
"130794","Yale University","2019","First major","'14'","Engineering","Doctor's degree - research/scholarship","31","22","9","0","0","0","3","2","1","1","0","1","2","2","0","0","0","0","15","10","5","1","1","0","0","0","0","9","7","2","-2"
"130794","Yale University","2019","Second major","'14'","Engineering","Bachelor's degree","14","6","8","0","0","0","1","0","1","0","0","0","1","0","1","0","0","0","9","6","3","0","0","0","0","0","0","3","0","3","-2"
"130907","Delaware Technical Community College-Terry","2019","First major","'14'","Engineering","Associate's degree","8","6","2","0","0","0","2","1","1","2","2","0","1","0","1","0","0","0","3","3","0","0","0","0","0","0","0","0","0","0","-2"
"130934","Delaware State University","2019","First major","'14'","Engineering","Bachelor's degree","17","9","8","0","0","0","0","0","0","13","7","6","0","0","0","0","0","0","2","1","1","0","0","0","0","0","0","2","1","1","-2"
"130943","University of Delaware","2019","First major","'14'","Engineering","Bachelor's degree","494","357","137","0","0","0","38","26","12","16","10","6","20","18","2","3","2","1","369","268","101","9","6","3","1","1","0","38","26","12","-2"
"130943","University of Delaware","2019","First major","'14'","Engineering","Master's degree","101","73","28","0","0","0","5","4","1","5","3","2","1","1","0","0","0","0","34","22","12","3","0","3","0","0","0","53","43","10","-2"
"130943","University of Delaware","2019","First major","'14'","Engineering","Doctor's degree - research/scholarship","68","52","16","0","0","0","7","3","4","3","2","1","2","2","0","0","0","0","20","16","4","1","1","0","1","1","0","34","27","7","-2"
"130943","University of Delaware","2019","Second major","'14'","Engineering","Bachelor's degree","3","2","1","0","0","0","1","0","1","0","0","0","0","0","0","0","0","0","2","2","0","0","0","0","0","0","0","0","0","0","-2"
"130943","University of Delaware","2019","Second major","'14'","Engineering","Master's degree","1","1","0","0","0","0","0","0","0","0","0","0","0","0","0","0","0","0","1","1","0","0","0","0","0","0","0","0","0","0","-2"
"131283","The Catholic University of America","2019","First major","'14'","Engineering","Bachelor's degree","92","66","26","0","0","0","3","2","1","7","5","2","8","5","3","0","0","0","45","34","11","5","3","2","2","1","1","22","16","6","-2"
"131283","The Catholic University of America","2019","First major","'14'","Engineering","Master's degree","45","30","15","0","0","0","3","1","2","1","1","0","1","1","0","0","0","0","12","7","5","5","3","2","0","0","0","23","17","6","-2"
"131283","The Catholic University of America","2019","First major","'14'","Engineering","Doctor's degree - research/scholarship","9","6","3","0","0","0","1","0","1","1","0","1","0","0","0","0","0","0","2","2","0","0","0","0","2","1","1","3","3","0","-2"
"131283","The Catholic University of America","2019","Second major","'14'","Engineering","Bachelor's degree","16","11","5","0","0","0","0","0","0","0","0","0","0","0","0","0","0","0","7","3","4","0","0","0","0","0","0","9","8","1","-2"
"131399","University of the District of Columbia","2019","First major","'14'","Engineering","Bachelor's degree","54","50","4","0","0","0","0","0","0","6","6","0","2","1","1","0","0","0","3","2","1","0","0","0","1","1","0","42","40","2","-2"
"131399","University of the District of Columbia","2019","First major","'14'","Engineering","Doctor's degree - research/scholarship","0","0","0","0","0","0","0","0","0","0","0","0","0","0","0","0","0","0","0","0","0","0","0","0","0","0","0","0","0","0","-2"
"131469","George Washington University","2019","First major","'14'","Engineering","Bachelor's degree","183","107","76","0","0","0","24","14","10","7","3","4","13","9","4","1","1","0","111","63","48","7","4","3","10","7","3","10","6","4","-2"
"131469","George Washington University","2019","First major","'14'","Engineering","Master's degree","242","176","66","1","0","1","14","9","5","11","6","5","4","3","1","0","0","0","45","27","18","1","1","0","9","6","3","157","124","33","-2"
"131469","George Washington University","2019","First major","'14'","Engineering","Doctor's degree - research/scholarship","35","25","10","0","0","0","3","3","0","3","3","0","1","1","0","0","0","0","18","11","7","0","0","0","1","1","0","9","6","3","-2"
"131520","Howard University","2019","First major","'14'","Engineering","Bachelor's degree","69","47","22","0","0","0","2","2","0","33","21","12","0","0","0","0","0","0","1","0","1","0","0","0","0","0","0","33","24","9","-2"
"131520","Howard University","2019","First major","'14'","Engineering","Master's degree","15","11","4","0","0","0","0","0","0","5","4","1","1","1","0","0","0","0","0","0","0","0","0","0","0","0","0","9","6","3","-2"
"131520","Howard University","2019","First major","'14'","Engineering","Doctor's degree - research/scholarship","6","5","1","0","0","0","0","0","0","0","0","0","0","0","0","0","0","0","0","0","0","0","0","0","0","0","0","6","5","1","-2"
"132602","Bethune-Cookman University","2019","First major","'14'","Engineering","Bachelor's degree","1","1","0","0","0","0","0","0","0","1","1","0","0","0","0","0","0","0","0","0","0","0","0","0","0","0","0","0","0","0","-2"
"132903","University of Central Florida","2019","First major","'14'","Engineering","Bachelor's degree","1032","842","190","1","1","0","74","58","16","63","54","9","255","204","51","3","3","0","562","463","99","44","34","10","6","4","2","24","21","3","-2"
"132903","University of Central Florida","2019","First major","'14'","Engineering","Master's degree","227","167","60","0","0","0","23","19","4","8","4","4","38","31","7","0","0","0","83","57","26","7","6","1","1","0","1","67","50","17","-2"
"132903","University of Central Florida","2019","First major","'14'","Engineering","Doctor's degree - research/scholarship","81","63","18","0","0","0","1","1","0","2","0","2","3","2","1","0","0","0","22","19","3","2","2","0","2","2","0","49","37","12","-2"
"133492","Eckerd College","2019","First major","'14'","Engineering","Bachelor's degree","0","0","0","0","0","0","0","0","0","0","0","0","0","0","0","0","0","0","0","0","0","0","0","0","0","0","0","0","0","0","-2"
"133553","Embry-Riddle Aeronautical University-Daytona Beach","2019","First major","'14'","Engineering","Bachelor's degree","379","310","69","1","1","0","15","14","1","17","9","8","34","27","7","0","0","0","227","190","37","17","13","4","15","11","4","53","45","8","-2"
"133553","Embry-Riddle Aeronautical University-Daytona Beach","2019","First major","'14'","Engineering","Master's degree","113","88","25","0","0","0","4","3","1","1","0","1","8","6","2","0","0","0","44","34","10","2","2","0","1","1","0","53","42","11","-2"
"133553","Embry-Riddle Aeronautical University-Daytona Beach","2019","First major","'14'","Engineering","Doctor's degree - research/scholarship","11","7","4","0","0","0","0","0","0","0","0","0","1","0","1","0","0","0","3","1","2","0","0","0","0","0","0","7","6","1","-2"
"133650","Florida Agricultural and Mechanical University","2019","First major","'14'","Engineering","Bachelor's degree","31","18","13","0","0","0","1","1","0","24","12","12","3","3","0","0","0","0","1","1","0","1","0","1","0","0","0","1","1","0","-2"
"133650","Florida Agricultural and Mechanical University","2019","First major","'14'","Engineering","Master's degree","14","11","3","0","0","0","1","1","0","11","8","3","0","0","0","0","0","0","0","0","0","0","0","0","0","0","0","2","2","0","-2"
"133650","Florida Agricultural and Mechanical University","2019","First major","'14'","Engineering","Doctor's degree - research/scholarship","5","3","2","0","0","0","0","0","0","4","2","2","0","0","0","0","0","0","0","0","0","0","0","0","0","0","0","1","1","0","-2"
"133669","Florida Atlantic University","2019","First major","'14'","Engineering","Bachelor's degree","267","232","35","0","0","0","14","8","6","44","42","2","72","61","11","0","0","0","119","104","15","4","4","0","0","0","0","14","13","1","-2"
"133669","Florida Atlantic University","2019","First major","'14'","Engineering","Master's degree","85","63","22","0","0","0","5","3","2","6","6","0","22","18","4","0","0","0","28","20","8","3","3","0","0","0","0","21","13","8","-2"
"133669","Florida Atlantic University","2019","First major","'14'","Engineering","Doctor's degree - research/scholarship","13","10","3","0","0","0","0","0","0","0","0","0","1","0","1","0","0","0","2","2","0","0","0","0","0","0","0","10","8","2","-2"
"133881","Florida Institute of Technology","2019","First major","'14'","Engineering","Bachelor's degree","368","288","80","0","0","0","10","8","2","13","8","5","32","25","7","0","0","0","134","104","30","14","11","3","3","1","2","162","131","31","-2"
"133881","Florida Institute of Technology","2019","First major","'14'","Engineering","Master's degree","165","136","29","0","0","0","5","5","0","3","2","1","7","1","6","0","0","0","59","52","7","4","3","1","1","1","0","86","72","14","-2"
"133881","Florida Institute of Technology","2019","First major","'14'","Engineering","Doctor's degree - research/scholarship","39","33","6","0","0","0","1","1","0","2","1","1","1","1","0","0","0","0","5","4","1","0","0","0","0","0","0","30","26","4","-2"
"133951","Florida International University","2019","First major","'14'","Engineering","Bachelor's degree","629","480","149","0","0","0","30","23","7","53","47","6","380","287","93","0","0","0","54","41","13","12","7","5","1","0","1","99","75","24","-2"
"133951","Florida International University","2019","First major","'14'","Engineering","Master's degree","163","112","51","0","0","0","3","2","1","12","7","5","57","45","12","0","0","0","9","8","1","2","2","0","0","0","0","80","48","32","-2"
"133951","Florida International University","2019","First major","'14'","Engineering","Doctor's degree - research/scholarship","33","24","9","0","0","0","1","1","0","0","0","0","1","1","0","0","0","0","5","5","0","0","0","0","1","0","1","25","17","8","-2"
"134097","Florida State University","2019","First major","'14'","Engineering","Bachelor's degree","396","298","98","2","2","0","6","6","0","20","12","8","61","51","10","0","0","0","249","187","62","20","13","7","5","4","1","33","23","10","-2"
"134097","Florida State University","2019","First major","'14'","Engineering","Master's degree","98","75","23","0","0","0","0","0","0","0","0","0","4","3","1","0","0","0","31","23","8","4","3","1","1","1","0","58","45","13","-2"
"134097","Florida State University","2019","First major","'14'","Engineering","Doctor's degree - research/scholarship","43","33","10","0","0","0","0","0","0","0","0","0","1","1","0","0","0","0","13","11","2","0","0","0","1","1","0","28","20","8","-2"
"134097","Florida State University","2019","Second major","'14'","Engineering","Bachelor's degree","3","2","1","0","0","0","0","0","0","0","0","0","0","0","0","0","0","0","2","1","1","0","0","0","0","0","0","1","1","0","-2"
"134130","University of Florida","2019","First major","'14'","Engineering","Bachelor's degree","1283","930","353","4","4","0","131","107","24","46","35","11","271","181","90","3","1","2","708","524","184","50","29","21","40","25","15","30","24","6","-2"
"134130","University of Florida","2019","First major","'14'","Engineering","Master's degree","665","499","166","0","0","0","26","19","7","18","13","5","50","35","15","0","0","0","180","140","40","3","2","1","11","9","2","377","281","96","-2"
"134130","University of Florida","2019","First major","'14'","Engineering","Doctor's degree - research/scholarship","157","121","36","0","0","0","5","5","0","5","1","4","8","6","2","0","0","0","47","37","10","1","1","0","5","4","1","86","67","19","-2"
"134237","Full Sail University","2019","First major","'14'","Engineering","Associate's degree","1","1","0","0","0","0","0","0","0","0","0","0","0","0","0","0","0","0","0","0","0","0","0","0","1","1","0","0","0","0","-2"
"134237","Full Sail University","2019","First major","'14'","Engineering","Bachelor's degree","20","18","2","0","0","0","2","1","1","2","2","0","3","3","0","0","0","0","12","11","1","0","0","0","1","1","0","0","0","0","-2"
"134945","Jacksonville University","2019","First major","'14'","Engineering","Bachelor's degree","16","15","1","0","0","0","1","1","0","2","1","1","4","4","0","0","0","0","6","6","0","1","1","0","0","0","0","2","2","0","-2"
"135081","Keiser University-Ft Lauderdale","2019","First major","'14'","Engineering","Bachelor's degree","26","22","4","0","0","0","0","0","0","4","3","1","16","14","2","0","0","0","4","3","1","1","1","0","1","1","0","0","0","0","-2"
"135726","University of Miami","2019","First major","'14'","Engineering","Bachelor's degree","252","176","76","0","0","0","13","9","4","12","8","4","60","38","22","0","0","0","76","54","22","13","7","6","7","4","3","71","56","15","-2"
"135726","University of Miami","2019","First major","'14'","Engineering","Master's degree","53","41","12","0","0","0","3","2","1","2","1","1","7","5","2","0","0","0","19","15","4","3","2","1","1","1","0","18","15","3","-2"
"135726","University of Miami","2019","First major","'14'","Engineering","Doctor's degree - research/scholarship","19","12","7","0","0","0","0","0","0","0","0","0","4","1","3","0","0","0","4","3","1","1","1","0","1","1","0","9","6","3","-2"
"136172","University of North Florida","2019","First major","'14'","Engineering","Bachelor's degree","139","121","18","0","0","0","6","6","0","2","1","1","17","14","3","0","0","0","103","92","11","6","5","1","0","0","0","5","3","2","-2"
"136172","University of North Florida","2019","First major","'14'","Engineering","Master's degree","19","15","4","0","0","0","1","0","1","0","0","0","2","1","1","0","0","0","11","9","2","0","0","0","0","0","0","5","5","0","-2"
"136215","Nova Southeastern University","2019","First major","'14'","Engineering","Bachelor's degree","3","3","0","0","0","0","0","0","0","1","1","0","1","1","0","0","0","0","1","1","0","0","0","0","0","0","0","0","0","0","-2"
"136215","Nova Southeastern University","2019","First major","'14'","Engineering","Master's degree","9","5","4","0","0","0","1","1","0","4","2","2","1","1","0","0","0","0","1","0","1","0","0","0","0","0","0","2","1","1","-2"
"136950","Rollins College","2019","First major","'14'","Engineering","Bachelor's degree","0","0","0","0","0","0","0","0","0","0","0","0","0","0","0","0","0","0","0","0","0","0","0","0","0","0","0","0","0","0","-2"
"137351","University of South Florida","2019","First major","'14'","Engineering","Bachelor's degree","653","517","136","0","0","0","40","31","9","37","32","5","126","96","30","0","0","0","286","228","58","17","15","2","14","14","0","133","101","32","-2"
"137351","University of South Florida","2019","First major","'14'","Engineering","Master's degree","363","289","74","0","0","0","2","1","1","2","1","1","18","12","6","0","0","0","38","30","8","4","2","2","3","1","2","296","242","54","-2"
"137351","University of South Florida","2019","First major","'14'","Engineering","Doctor's degree - research/scholarship","62","46","16","0","0","0","4","4","0","2","1","1","1","0","1","0","0","0","18","11","7","0","0","0","0","0","0","37","30","7","-2"
"138309","Rasmussen University-Florida","2019","First major","'14'","Engineering","Associate's degree","16","13","3","0","0","0","1","1","0","2","2","0","2","1","1","0","0","0","10","8","2","0","0","0","1","1","0","0","0","0","-2"
"138354","The University of West Florida","2019","First major","'14'","Engineering","Bachelor's degree","89","79","10","1","1","0","5","5","0","7","6","1","4","4","0","0","0","0","57","49","8","6","5","1","3","3","0","6","6","0","-2"
"138354","The University of West Florida","2019","Second major","'14'","Engineering","Bachelor's degree","12","12","0","0","0","0","0","0","0","0","0","0","0","0","0","0","0","0","9","9","0","1","1","0","0","0","0","2","2","0","-2"
"138761","Andrew College","2019","First major","'14'","Engineering","Associate's degree","0","0","0","0","0","0","0","0","0","0","0","0","0","0","0","0","0","0","0","0","0","0","0","0","0","0","0","0","0","0","-2"
"139366","Columbus State University","2019","First major","'14'","Engineering","Associate's degree","7","7","0","0","0","0","0","0","0","3","3","0","1","1","0","0","0","0","3","3","0","0","0","0","0","0","0","0","0","0","-2"
"139658","Emory University","2019","First major","'14'","Engineering","Master's degree","1","1","0","0","0","0","0","0","0","0","0","0","0","0","0","0","0","0","0","0","0","1","1","0","0","0","0","0","0","0","-2"
"139658","Emory University","2019","First major","'14'","Engineering","Doctor's degree - research/scholarship","30","21","9","0","0","0","5","3","2","3","1","2","0","0","0","1","1","0","15","12","3","0","0","0","4","2","2","2","2","0","-2"
"139755","Georgia Institute of Technology-Main Campus","2019","First major","'14'","Engineering","Bachelor's degree","2194","1498","696","0","0","0","432","277","155","125","82","43","164","121","43","0","0","0","1113","764","349","75","54","21","66","47","19","219","153","66","-2"
"139755","Georgia Institute of Technology-Main Campus","2019","First major","'14'","Engineering","Master's degree","1045","779","266","0","0","0","108","76","32","24","20","4","51","36","15","0","0","0","329","272","57","22","15","7","0","0","0","511","360","151","-2"
"139755","Georgia Institute of Technology-Main Campus","2019","First major","'14'","Engineering","Doctor's degree - research/scholarship","320","254","66","0","0","0","28","21","7","9","7","2","11","8","3","1","1","0","94","77","17","7","7","0","0","0","0","170","133","37","-2"
"139931","Georgia Southern University","2019","First major","'14'","Engineering","Bachelor's degree","317","282","35","1","1","0","8","8","0","62","54","8","19","17","2","0","0","0","207","187","20","3","3","0","1","1","0","16","11","5","-2"
"139931","Georgia Southern University","2019","First major","'14'","Engineering","Master's degree","7","4","3","0","0","0","1","1","0","1","0","1","0","0","0","0","0","0","0","0","0","0","0","0","0","0","0","5","3","2","-2"
"139940","Georgia State University","2019","First major","'14'","Engineering","Master's degree","0","0","0","0","0","0","0","0","0","0","0","0","0","0","0","0","0","0","0","0","0","0","0","0","0","0","0","0","0","0","-2"
"139959","University of Georgia","2019","First major","'14'","Engineering","Bachelor's degree","332","244","88","0","0","0","33","23","10","25","17","8","15","12","3","1","1","0","231","172","59","14","11","3","7","5","2","6","3","3","-2"
"139959","University of Georgia","2019","First major","'14'","Engineering","Master's degree","27","14","13","0","0","0","1","1","0","2","1","1","2","2","0","0","0","0","14","7","7","2","0","2","0","0","0","6","3","3","-2"
"139959","University of Georgia","2019","First major","'14'","Engineering","Doctor's degree - research/scholarship","10","6","4","0","0","0","0","0","0","0","0","0","0","0","0","0","0","0","3","3","0","0","0","0","0","0","0","7","3","4","-2"
"139968","Gordon State College","2019","First major","'14'","Engineering","Associate's degree","2","1","1","0","0","0","0","0","0","1","1","0","0","0","0","0","0","0","0","0","0","0","0","0","0","0","0","1","0","1","-2"
"140234","LaGrange College","2019","First major","'14'","Engineering","Bachelor's degree","0","0","0","0","0","0","0","0","0","0","0","0","0","0","0","0","0","0","0","0","0","0","0","0","0","0","0","0","0","0","-2"
"140447","Mercer University","2019","First major","'14'","Engineering","Bachelor's degree","132","101","31","0","0","0","10","7","3","14","7","7","7","6","1","0","0","0","87","70","17","7","6","1","2","1","1","5","4","1","-2"
"140447","Mercer University","2019","First major","'14'","Engineering","Master's degree","65","49","16","1","0","1","6","5","1","2","0","2","5","3","2","0","0","0","34","30","4","0","0","0","15","10","5","2","1","1","-2"
"140447","Mercer University","2019","Second major","'14'","Engineering","Bachelor's degree","1","1","0","0","0","0","0","0","0","0","0","0","0","0","0","0","0","0","1","1","0","0","0","0","0","0","0","0","0","0","-2"
"140553","Morehouse College","2019","First major","'14'","Engineering","Bachelor's degree","18","18","0","0","0","0","0","0","0","15","15","0","0","0","0","0","0","0","0","0","0","1","1","0","2","2","0","0","0","0","-2"
"140696","Oglethorpe University","2019","First major","'14'","Engineering","Bachelor's degree","4","3","1","0","0","0","0","0","0","1","0","1","0","0","0","0","0","0","1","1","0","0","0","0","1","1","0","1","1","0","-2"
"140818","Piedmont University","2019","First major","'14'","Engineering","Bachelor's degree","1","1","0","0","0","0","0","0","0","0","0","0","0","0","0","0","0","0","1","1","0","0","0","0","0","0","0","0","0","0","-2"
"140951","Savannah College of Art and Design","2019","First major","'14'","Engineering","Bachelor's degree","4","1","3","0","0","0","1","0","1","0","0","0","1","1","0","0","0","0","2","0","2","0","0","0","0","0","0","0","0","0","-2"
"140951","Savannah College of Art and Design","2019","First major","'14'","Engineering","Master's degree","10","6","4","0","0","0","0","0","0","0","0","0","1","1","0","0","0","0","1","1","0","0","0","0","0","0","0","8","4","4","-2"
"141060","Spelman College","2019","First major","'14'","Engineering","Bachelor's degree","0","0","0","0","0","0","0","0","0","0","0","0","0","0","0","0","0","0","0","0","0","0","0","0","0","0","0","0","0","0","-2"
"141325","Wesleyan College","2019","First major","'14'","Engineering","Bachelor's degree","1","0","1","0","0","0","0","0","0","0","0","0","1","0","1","0","0","0","0","0","0","0","0","0","0","0","0","0","0","0","-2"
"141574","University of Hawaii at Manoa","2019","First major","'14'","Engineering","Bachelor's degree","293","225","68","0","0","0","181","138","43","0","0","0","12","8","4","5","5","0","24","19","5","67","51","16","1","1","0","3","3","0","-2"
"141574","University of Hawaii at Manoa","2019","First major","'14'","Engineering","Master's degree","34","24","10","0","0","0","9","5","4","0","0","0","3","2","1","1","1","0","8","5","3","6","6","0","0","0","0","7","5","2","-2"
"141574","University of Hawaii at Manoa","2019","First major","'14'","Engineering","Doctor's degree - research/scholarship","18","12","6","0","0","0","1","1","0","0","0","0","0","0","0","1","1","0","2","1","1","0","0","0","0","0","0","14","9","5","-2"
"141644","Hawaii Pacific University","2019","First major","'14'","Engineering","Bachelor's degree","0","0","0","0","0","0","0","0","0","0","0","0","0","0","0","0","0","0","0","0","0","0","0","0","0","0","0","0","0","0","-2"
"142115","Boise State University","2019","First major","'14'","Engineering","Bachelor's degree","199","160","39","0","0","0","5","4","1","0","0","0","13","9","4","0","0","0","149","121","28","5","3","2","2","2","0","25","21","4","-2"
"142115","Boise State University","2019","First major","'14'","Engineering","Master's degree","28","21","7","0","0","0","0","0","0","0","0","0","3","2","1","0","0","0","17","13","4","0","0","0","0","0","0","8","6","2","-2"
"142115","Boise State University","2019","First major","'14'","Engineering","Doctor's degree - research/scholarship","8","7","1","0","0","0","0","0","0","0","0","0","0","0","0","0","0","0","3","2","1","0","0","0","0","0","0","5","5","0","-2"
"142115","Boise State University","2019","Second major","'14'","Engineering","Bachelor's degree","1","1","0","0","0","0","0","0","0","0","0","0","0","0","0","0","0","0","1","1","0","0","0","0","0","0","0","0","0","0","-2"
"142276","Idaho State University","2019","First major","'14'","Engineering","Bachelor's degree","136","126","10","0","0","0","0","0","0","0","0","0","7","6","1","0","0","0","53","48","5","0","0","0","1","1","0","75","71","4","-2"
"142276","Idaho State University","2019","First major","'14'","Engineering","Master's degree","14","13","1","0","0","0","1","0","1","0","0","0","1","1","0","0","0","0","3","3","0","2","2","0","0","0","0","7","7","0","-2"
"142276","Idaho State University","2019","First major","'14'","Engineering","Doctor's degree - research/scholarship","3","3","0","0","0","0","0","0","0","0","0","0","0","0","0","0","0","0","2","2","0","0","0","0","0","0","0","1","1","0","-2"
"142276","Idaho State University","2019","Second major","'14'","Engineering","Bachelor's degree","1","0","1","0","0","0","0","0","0","0","0","0","0","0","0","0","0","0","1","0","1","0","0","0","0","0","0","0","0","0","-2"
"142285","University of Idaho","2019","First major","'14'","Engineering","Bachelor's degree","227","188","39","1","1","0","2","1","1","2","1","1","8","6","2","0","0","0","150","124","26","6","4","2","6","5","1","52","46","6","-2"
"142285","University of Idaho","2019","First major","'14'","Engineering","Master's degree","72","57","15","0","0","0","1","0","1","0","0","0","6","4","2","0","0","0","42","34","8","2","2","0","2","1","1","19","16","3","-2"
"142285","University of Idaho","2019","First major","'14'","Engineering","Doctor's degree - research/scholarship","9","6","3","0","0","0","0","0","0","0","0","0","0","0","0","0","0","0","3","1","2","1","0","1","0","0","0","5","5","0","-2"
"142294","The College of Idaho","2019","First major","'14'","Engineering","Bachelor's degree","0","0","0","0","0","0","0","0","0","0","0","0","0","0","0","0","0","0","0","0","0","0","0","0","0","0","0","0","0","0","-2"
"142328","Lewis-Clark State College","2019","First major","'14'","Engineering","Associate's degree","5","4","1","1","1","0","0","0","0","0","0","0","1","1","0","0","0","0","2","1","1","0","0","0","0","0","0","1","1","0","-2"
"142443","North Idaho College","2019","First major","'14'","Engineering","Associate's degree","8","6","2","0","0","0","1","1","0","0","0","0","0","0","0","1","1","0","6","4","2","0","0","0","0","0","0","0","0","0","-2"
"142461","Northwest Nazarene University","2019","First major","'14'","Engineering","Bachelor's degree","21","15","6","0","0","0","0","0","0","0","0","0","2","2","0","0","0","0","19","13","6","0","0","0","0","0","0","0","0","0","-2"
"142522","Brigham Young University-Idaho","2019","First major","'14'","Engineering","Bachelor's degree","197","186","11","1","1","0","6","6","0","1","1","0","3","2","1","0","0","0","160","154","6","8","7","1","1","1","0","17","14","3","-2"
"142559","College of Southern Idaho","2019","First major","'14'","Engineering","Associate's degree","7","6","1","0","0","0","1","1","0","0","0","0","2","2","0","0","0","0","3","2","1","1","1","0","0","0","0","0","0","0","-2"
"143084","Augustana College","2019","First major","'14'","Engineering","Bachelor's degree","13","11","2","0","0","0","1","0","1","0","0","0","0","0","0","0","0","0","11","11","0","0","0","0","0","0","0","1","0","1","-2"
"143118","Aurora University","2019","First major","'14'","Engineering","Bachelor's degree","0","0","0","0","0","0","0","0","0","0","0","0","0","0","0","0","0","0","0","0","0","0","0","0","0","0","0","0","0","0","-2"
"143215","Southwestern Illinois College","2019","First major","'14'","Engineering","Associate's degree","3","3","0","0","0","0","0","0","0","1","1","0","0","0","0","0","0","0","1","1","0","1","1","0","0","0","0","0","0","0","-2"
"143358","Bradley University","2019","First major","'14'","Engineering","Bachelor's degree","200","178","22","0","0","0","7","4","3","4","3","1","9","8","1","0","0","0","157","142","15","13","12","1","3","2","1","7","7","0","-2"
"143358","Bradley University","2019","First major","'14'","Engineering","Master's degree","35","27","8","0","0","0","1","1","0","2","2","0","0","0","0","0","0","0","5","3","2","0","0","0","0","0","0","27","21","6","-2"
"143358","Bradley University","2019","Second major","'14'","Engineering","Bachelor's degree","3","1","2","0","0","0","1","0","1","0","0","0","0","0","0","0","0","0","2","1","1","0","0","0","0","0","0","0","0","0","-2"
"144050","University of Chicago","2019","First major","'14'","Engineering","Bachelor's degree","22","16","6","0","0","0","4","3","1","0","0","0","2","1","1","0","0","0","13","9","4","0","0","0","0","0","0","3","3","0","-2"
"144050","University of Chicago","2019","First major","'14'","Engineering","Master's degree","3","2","1","0","0","0","0","0","0","0","0","0","0","0","0","0","0","0","3","2","1","0","0","0","0","0","0","0","0","0","-2"
"144050","University of Chicago","2019","First major","'14'","Engineering","Doctor's degree - research/scholarship","5","3","2","0","0","0","1","1","0","0","0","0","0","0","0","0","0","0","2","1","1","0","0","0","0","0","0","2","1","1","-2"
"144050","University of Chicago","2019","Second major","'14'","Engineering","Bachelor's degree","6","5","1","0","0","0","0","0","0","0","0","0","1","1","0","0","0","0","4","3","1","0","0","0","0","0","0","1","1","0","-2"
"144184","City Colleges of Chicago-Harry S Truman College","2019","First major","'14'","Engineering","Associate's degree","2","2","0","0","0","0","0","0","0","0","0","0","0","0","0","0","0","0","1","1","0","0","0","0","1","1","0","0","0","0","-2"
"144193","City Colleges of Chicago-Richard J Daley College","2019","First major","'14'","Engineering","Associate's degree","7","6","1","0","0","0","0","0","0","3","2","1","4","4","0","0","0","0","0","0","0","0","0","0","0","0","0","0","0","0","-2"
"144209","City Colleges of Chicago-Harold Washington College","2019","First major","'14'","Engineering","Associate's degree","0","0","0","0","0","0","0","0","0","0","0","0","0","0","0","0","0","0","0","0","0","0","0","0","0","0","0","0","0","0","-2"
"144218","City Colleges of Chicago-Wilbur Wright College","2019","First major","'14'","Engineering","Associate's degree","5","5","0","0","0","0","2","2","0","0","0","0","2","2","0","0","0","0","1","1","0","0","0","0","0","0","0","0","0","0","-2"
"144564","Danville Area Community College","2019","First major","'14'","Engineering","Associate's degree","2","2","0","0","0","0","0","0","0","0","0","0","0","0","0","0","0","0","1","1","0","1","1","0","0","0","0","0","0","0","-2"
"144865","College of DuPage","2019","First major","'14'","Engineering","Associate's degree","45","39","6","0","0","0","5","4","1","0","0","0","7","5","2","0","0","0","30","27","3","0","0","0","1","1","0","2","2","0","-2"
"144892","Eastern Illinois University","2019","First major","'14'","Engineering","Bachelor's degree","0","0","0","0","0","0","0","0","0","0","0","0","0","0","0","0","0","0","0","0","0","0","0","0","0","0","0","0","0","0","-2"
"144944","Elgin Community College","2019","First major","'14'","Engineering","Associate's degree","20","15","5","0","0","0","1","1","0","0","0","0","6","5","1","0","0","0","13","9","4","0","0","0","0","0","0","0","0","0","-2"
"145521","Highland Community College","2019","First major","'14'","Engineering","Associate's degree","2","2","0","0","0","0","0","0","0","0","0","0","0","0","0","0","0","0","2","2","0","0","0","0","0","0","0","0","0","0","-2"
"145600","University of Illinois Chicago","2019","First major","'14'","Engineering","Bachelor's degree","518","405","113","1","1","0","124","92","32","39","29","10","110","90","20","0","0","0","190","149","41","16","12","4","18","18","0","20","14","6","-2"
"145600","University of Illinois Chicago","2019","First major","'14'","Engineering","Master's degree","428","321","107","0","0","0","16","12","4","5","4","1","16","11","5","0","0","0","55","45","10","3","3","0","3","3","0","330","243","87","-2"
"145600","University of Illinois Chicago","2019","First major","'14'","Engineering","Doctor's degree - research/scholarship","62","44","18","0","0","0","4","3","1","2","1","1","1","1","0","0","0","0","11","8","3","2","2","0","0","0","0","42","29","13","-2"
"145619","Benedictine University","2019","First major","'14'","Engineering","Bachelor's degree","5","2","3","0","0","0","0","0","0","0","0","0","2","1","1","0","0","0","3","1","2","0","0","0","0","0","0","0","0","0","-2"
"145637","University of Illinois Urbana-Champaign","2019","First major","'14'","Engineering","Bachelor's degree","1823","1473","350","1","0","1","411","329","82","27","19","8","114","91","23","0","0","0","787","648","139","55","45","10","8","7","1","420","334","86","-2"
"145637","University of Illinois Urbana-Champaign","2019","First major","'14'","Engineering","Master's degree","797","590","207","0","0","0","78","60","18","11","8","3","23","20","3","0","0","0","167","124","43","6","4","2","4","4","0","508","370","138","-2"
"145637","University of Illinois Urbana-Champaign","2019","First major","'14'","Engineering","Doctor's degree - research/scholarship","234","180","54","1","1","0","20","12","8","1","0","1","3","3","0","0","0","0","54","38","16","1","1","0","2","2","0","152","123","29","-2"
"145682","Illinois Central College","2019","First major","'14'","Engineering","Associate's degree","26","24","2","0","0","0","1","1","0","2","2","0","2","2","0","0","0","0","19","17","2","0","0","0","0","0","0","2","2","0","-2"
"145707","Olney Central College","2019","First major","'14'","Engineering","Associate's degree","0","0","0","0","0","0","0","0","0","0","0","0","0","0","0","0","0","0","0","0","0","0","0","0","0","0","0","0","0","0","-2"
"145725","Illinois Institute of Technology","2019","First major","'14'","Engineering","Bachelor's degree","310","214","96","0","0","0","43","31","12","11","7","4","52","39","13","0","0","0","108","71","37","8","6","2","14","7","7","74","53","21","-2"
"145725","Illinois Institute of Technology","2019","First major","'14'","Engineering","Master's degree","382","296","86","0","0","0","14","11","3","10","7","3","8","5","3","0","0","0","54","42","12","4","2","2","5","2","3","287","227","60","-2"
"145725","Illinois Institute of Technology","2019","First major","'14'","Engineering","Doctor's degree - research/scholarship","45","35","10","0","0","0","1","0","1","0","0","0","0","0","0","0","0","0","1","1","0","0","0","0","1","1","0","42","33","9","-2"
"145831","Illinois Valley Community College","2019","First major","'14'","Engineering","Associate's degree","4","4","0","0","0","0","0","0","0","0","0","0","0","0","0","0","0","0","3","3","0","0","0","0","1","1","0","0","0","0","-2"
"146205","John A Logan College","2019","First major","'14'","Engineering","Associate's degree","1","1","0","0","0","0","0","0","0","0","0","0","0","0","0","0","0","0","1","1","0","0","0","0","0","0","0","0","0","0","-2"
"146278","John Wood Community College","2019","First major","'14'","Engineering","Associate's degree","4","3","1","0","0","0","0","0","0","0","0","0","1","1","0","0","0","0","3","2","1","0","0","0","0","0","0","0","0","0","-2"
"146348","Kankakee Community College","2019","First major","'14'","Engineering","Associate's degree","7","7","0","0","0","0","0","0","0","0","0","0","0","0","0","0","0","0","7","7","0","0","0","0","0","0","0","0","0","0","-2"
"146366","Kaskaskia College","2019","First major","'14'","Engineering","Associate's degree","6","6","0","0","0","0","0","0","0","0","0","0","0","0","0","0","0","0","6","6","0","0","0","0","0","0","0","0","0","0","-2"
"146418","Kishwaukee College","2019","First major","'14'","Engineering","Associate's degree","9","8","1","0","0","0","1","1","0","0","0","0","1","1","0","0","0","0","6","5","1","0","0","0","1","1","0","0","0","0","-2"
"146472","College of Lake County","2019","First major","'14'","Engineering","Associate's degree","22","20","2","0","0","0","1","1","0","0","0","0","9","8","1","0","0","0","10","9","1","0","0","0","1","1","0","1","1","0","-2"
"146506","Lake Land College","2019","First major","'14'","Engineering","Associate's degree","7","7","0","0","0","0","0","0","0","0","0","0","0","0","0","0","0","0","7","7","0","0","0","0","0","0","0","0","0","0","-2"
"146603","Lewis and Clark Community College","2019","First major","'14'","Engineering","Associate's degree","10","10","0","0","0","0","0","0","0","0","0","0","0","0","0","0","0","0","10","10","0","0","0","0","0","0","0","0","0","0","-2"
"146612","Lewis University","2019","First major","'14'","Engineering","Bachelor's degree","5","5","0","0","0","0","0","0","0","0","0","0","2","2","0","0","0","0","3","3","0","0","0","0","0","0","0","0","0","0","-2"
"146685","Lincoln Land Community College","2019","First major","'14'","Engineering","Associate's degree","6","5","1","0","0","0","0","0","0","2","1","1","2","2","0","0","0","0","1","1","0","0","0","0","1","1","0","0","0","0","-2"
"146719","Loyola University Chicago","2019","First major","'14'","Engineering","Bachelor's degree","27","16","11","0","0","0","2","0","2","1","1","0","3","2","1","0","0","0","16","10","6","2","0","2","2","2","0","1","1","0","-2"
"146719","Loyola University Chicago","2019","First major","'14'","Engineering","Master's degree","19","14","5","0","0","0","2","2","0","2","1","1","1","1","0","0","0","0","8","6","2","0","0","0","1","1","0","5","3","2","-2"
"147004","McHenry County College","2019","First major","'14'","Engineering","Associate's degree","7","7","0","0","0","0","0","0","0","0","0","0","0","0","0","0","0","0","7","7","0","0","0","0","0","0","0","0","0","0","-2"
"147679","North Park University","2019","First major","'14'","Engineering","Bachelor's degree","8","6","2","0","0","0","1","1","0","1","0","1","3","3","0","0","0","0","0","0","0","1","1","0","0","0","0","2","1","1","-2"
"147703","Northern Illinois University","2019","First major","'14'","Engineering","Bachelor's degree","279","240","39","0","0","0","16","11","5","8","8","0","41","36","5","0","0","0","178","153","25","14","11","3","0","0","0","22","21","1","-2"
"147703","Northern Illinois University","2019","First major","'14'","Engineering","Master's degree","116","94","22","0","0","0","7","6","1","5","5","0","3","3","0","0","0","0","24","22","2","1","1","0","0","0","0","76","57","19","-2"
"147767","Northwestern University","2019","First major","'14'","Engineering","Bachelor's degree","373","248","125","1","0","1","81","55","26","15","7","8","35","20","15","0","0","0","187","129","58","8","2","6","10","7","3","36","28","8","-2"
"147767","Northwestern University","2019","First major","'14'","Engineering","Master's degree","378","249","129","0","0","0","42","27","15","13","8","5","9","5","4","0","0","0","91","56","35","5","3","2","11","7","4","207","143","64","-2"
"147767","Northwestern University","2019","First major","'14'","Engineering","Doctor's degree - research/scholarship","135","100","35","0","0","0","11","7","4","1","0","1","8","8","0","0","0","0","34","26","8","1","0","1","3","3","0","77","56","21","-2"
"147800","Oakton Community College","2019","First major","'14'","Engineering","Associate's degree","19","15","4","0","0","0","8","5","3","0","0","0","2","2","0","1","1","0","5","4","1","1","1","0","0","0","0","2","2","0","-2"
"147828","Olivet Nazarene University","2019","First major","'14'","Engineering","Bachelor's degree","63","51","12","1","1","0","1","1","0","1","1","0","6","3","3","0","0","0","53","44","9","0","0","0","0","0","0","1","1","0","-2"
"147916","Parkland College","2019","First major","'14'","Engineering","Associate's degree","17","15","2","0","0","0","3","2","1","1","1","0","0","0","0","0","0","0","11","10","1","0","0","0","1","1","0","1","1","0","-2"
"148016","Principia College","2019","First major","'14'","Engineering","Bachelor's degree","6","3","3","0","0","0","0","0","0","0","0","0","0","0","0","0","0","0","4","3","1","0","0","0","0","0","0","2","0","2","-2"
"148016","Principia College","2019","Second major","'14'","Engineering","Bachelor's degree","1","1","0","0","0","0","0","0","0","0","0","0","0","0","0","0","0","0","0","0","0","0","0","0","0","0","0","1","1","0","-2"
"148256","Rend Lake College","2019","First major","'14'","Engineering","Associate's degree","5","4","1","0","0","0","0","0","0","0","0","0","0","0","0","0","0","0","4","3","1","1","1","0","0","0","0","0","0","0","-2"
"148292","Richland Community College","2019","First major","'14'","Engineering","Associate's degree","6","6","0","1","1","0","0","0","0","0","0","0","0","0","0","0","0","0","5","5","0","0","0","0","0","0","0","0","0","0","-2"
"148380","Rock Valley College","2019","First major","'14'","Engineering","Associate's degree","21","18","3","0","0","0","0","0","0","3","3","0","5","5","0","0","0","0","11","9","2","0","0","0","0","0","0","2","1","1","-2"
"148511","Rush University","2019","First major","'14'","Engineering","Doctor's degree - research/scholarship","2","1","1","0","0","0","0","0","0","0","0","0","0","0","0","0","0","0","1","0","1","0","0","0","0","0","0","1","1","0","-2"
"148672","Sauk Valley Community College","2019","First major","'14'","Engineering","Associate's degree","3","1","2","0","0","0","0","0","0","0","0","0","0","0","0","0","0","0","3","1","2","0","0","0","0","0","0","0","0","0","-2"
"148937","Southeastern Illinois College","2019","First major","'14'","Engineering","Associate's degree","0","0","0","0","0","0","0","0","0","0","0","0","0","0","0","0","0","0","0","0","0","0","0","0","0","0","0","0","0","0","-2"
"149222","Southern Illinois University-Carbondale","2019","First major","'14'","Engineering","Bachelor's degree","223","194","29","0","0","0","5","2","3","5","4","1","13","12","1","0","0","0","152","130","22","2","2","0","2","2","0","44","42","2","-2"
"149222","Southern Illinois University-Carbondale","2019","First major","'14'","Engineering","Master's degree","46","38","8","0","0","0","0","0","0","0","0","0","1","1","0","0","0","0","8","5","3","0","0","0","0","0","0","37","32","5","-2"
"149222","Southern Illinois University-Carbondale","2019","First major","'14'","Engineering","Doctor's degree - research/scholarship","17","16","1","0","0","0","1","1","0","1","1","0","0","0","0","0","0","0","2","2","0","0","0","0","0","0","0","13","12","1","-2"
"149231","Southern Illinois University-Edwardsville","2019","First major","'14'","Engineering","Bachelor's degree","263","219","44","1","1","0","7","3","4","7","5","2","6","5","1","0","0","0","194","175","19","6","4","2","1","1","0","41","25","16","-2"
"149231","Southern Illinois University-Edwardsville","2019","First major","'14'","Engineering","Master's degree","88","68","20","0","0","0","6","5","1","0","0","0","0","0","0","0","0","0","23","21","2","1","1","0","0","0","0","58","41","17","-2"
"149365","South Suburban College","2019","First major","'14'","Engineering","Associate's degree","0","0","0","0","0","0","0","0","0","0","0","0","0","0","0","0","0","0","0","0","0","0","0","0","0","0","0","0","0","0","-2"
"149727","Waubonsee Community College","2019","First major","'14'","Engineering","Associate's degree","4","3","1","0","0","0","0","0","0","1","1","0","0","0","0","0","0","0","3","2","1","0","0","0","0","0","0","0","0","0","-2"
"149772","Western Illinois University","2019","First major","'14'","Engineering","Bachelor's degree","14","11","3","0","0","0","0","0","0","0","0","0","1","1","0","0","0","0","12","9","3","1","1","0","0","0","0","0","0","0","-2"
"149781","Wheaton College","2019","First major","'14'","Engineering","Bachelor's degree","7","6","1","0","0","0","4","3","1","0","0","0","0","0","0","0","0","0","1","1","0","1","1","0","0","0","0","1","1","0","-2"
"149842","William Rainey Harper College","2019","First major","'14'","Engineering","Associate's degree","37","28","9","0","0","0","7","6","1","0","0","0","8","4","4","0","0","0","20","16","4","2","2","0","0","0","0","0","0","0","-2"
"150066","Anderson University","2019","First major","'14'","Engineering","Bachelor's degree","6","6","0","0","0","0","0","0","0","1","1","0","0","0","0","0","0","0","5","5","0","0","0","0","0","0","0","0","0","0","-2"
"150136","Ball State University","2019","First major","'14'","Engineering","Bachelor's degree","0","0","0","0","0","0","0","0","0","0","0","0","0","0","0","0","0","0","0","0","0","0","0","0","0","0","0","0","0","0","-2"
"150136","Ball State University","2019","First major","'14'","Engineering","Master's degree","0","0","0","0","0","0","0","0","0","0","0","0","0","0","0","0","0","0","0","0","0","0","0","0","0","0","0","0","0","0","-2"
"150145","Bethel University","2019","First major","'14'","Engineering","Bachelor's degree","4","2","2","0","0","0","0","0","0","0","0","0","0","0","0","0","0","0","4","2","2","0","0","0","0","0","0","0","0","0","-2"
"150163","Butler University","2019","First major","'14'","Engineering","Bachelor's degree","4","2","2","0","0","0","0","0","0","0","0","0","0","0","0","0","0","0","4","2","2","0","0","0","0","0","0","0","0","0","-2"
"150400","DePauw University","2019","First major","'14'","Engineering","Bachelor's degree","3","0","3","0","0","0","1","0","1","0","0","0","0","0","0","0","0","0","0","0","0","0","0","0","0","0","0","2","0","2","-2"
"150400","DePauw University","2019","Second major","'14'","Engineering","Bachelor's degree","1","1","0","0","0","0","0","0","0","0","0","0","0","0","0","0","0","0","0","0","0","1","1","0","0","0","0","0","0","0","-2"
"150534","University of Evansville","2019","First major","'14'","Engineering","Bachelor's degree","61","52","9","0","0","0","2","2","0","0","0","0","0","0","0","0","0","0","41","33","8","0","0","0","2","2","0","16","15","1","-2"
"150668","Goshen College","2019","First major","'14'","Engineering","Bachelor's degree","1","1","0","0","0","0","0","0","0","0","0","0","0","0","0","0","0","0","1","1","0","0","0","0","0","0","0","0","0","0","-2"
"150677","Grace College and Theological Seminary","2019","First major","'14'","Engineering","Bachelor's degree","9","7","2","0","0","0","0","0","0","0","0","0","1","1","0","0","0","0","7","5","2","1","1","0","0","0","0","0","0","0","-2"
"150677","Grace College and Theological Seminary","2019","Second major","'14'","Engineering","Bachelor's degree","1","1","0","0","0","0","0","0","0","0","0","0","0","0","0","0","0","0","1","1","0","0","0","0","0","0","0","0","0","0","-2"
"150987","Ivy Tech Community College","2019","First major","'14'","Engineering","Associate's degree","26","22","4","0","0","0","2","1","1","3","3","0","2","1","1","1","1","0","11","11","0","1","0","1","1","1","0","5","4","1","-2"
"151102","Purdue University Fort Wayne","2019","First major","'14'","Engineering","Bachelor's degree","61","50","11","0","0","0","1","0","1","0","0","0","6","6","0","0","0","0","44","37","7","1","1","0","0","0","0","9","6","3","-2"
"151102","Purdue University Fort Wayne","2019","First major","'14'","Engineering","Master's degree","23","19","4","0","0","0","2","1","1","0","0","0","1","1","0","0","0","0","10","8","2","0","0","0","0","0","0","10","9","1","-2"
"151111","Indiana University-Purdue University-Indianapolis","2019","First major","'14'","Engineering","Bachelor's degree","326","284","42","1","0","1","11","10","1","11","8","3","15","12","3","0","0","0","221","200","21","10","7","3","1","1","0","56","46","10","-2"
"151111","Indiana University-Purdue University-Indianapolis","2019","First major","'14'","Engineering","Master's degree","154","128","26","0","0","0","5","4","1","3","3","0","4","3","1","0","0","0","39","34","5","0","0","0","0","0","0","103","84","19","-2"
"151290","Indiana Institute of Technology","2019","First major","'14'","Engineering","Associate's degree","0","0","0","0","0","0","0","0","0","0","0","0","0","0","0","0","0","0","0","0","0","0","0","0","0","0","0","0","0","0","-2"
"151290","Indiana Institute of Technology","2019","First major","'14'","Engineering","Bachelor's degree","91","82","9","0","0","0","0","0","0","6","4","2","2","2","0","0","0","0","35","30","5","1","1","0","4","3","1","43","42","1","-2"
"151306","University of Southern Indiana","2019","First major","'14'","Engineering","Bachelor's degree","52","48","4","0","0","0","2","2","0","1","1","0","0","0","0","0","0","0","46","42","4","1","1","0","0","0","0","2","2","0","-2"
"151324","Indiana State University","2019","First major","'14'","Engineering","Bachelor's degree","0","0","0","0","0","0","0","0","0","0","0","0","0","0","0","0","0","0","0","0","0","0","0","0","0","0","0","0","0","0","-2"
"151351","Indiana University-Bloomington","2019","First major","'14'","Engineering","Master's degree","7","5","2","0","0","0","0","0","0","0","0","0","0","0","0","0","0","0","0","0","0","0","0","0","2","1","1","5","4","1","-2"
"151777","Manchester University","2019","First major","'14'","Engineering","Bachelor's degree","3","3","0","0","0","0","0","0","0","0","0","0","0","0","0","0","0","0","1","1","0","0","0","0","1","1","0","1","1","0","-2"
"151777","Manchester University","2019","Second major","'14'","Engineering","Bachelor's degree","1","1","0","0","0","0","0","0","0","0","0","0","0","0","0","0","0","0","1","1","0","0","0","0","0","0","0","0","0","0","-2"
"152080","University of Notre Dame","2019","First major","'14'","Engineering","Bachelor's degree","346","238","108","1","0","1","12","8","4","4","2","2","35","28","7","0","0","0","262","178","84","13","8","5","3","2","1","16","12","4","-2"
"152080","University of Notre Dame","2019","First major","'14'","Engineering","Master's degree","110","78","32","0","0","0","3","1","2","3","1","2","8","4","4","0","0","0","53","41","12","3","3","0","0","0","0","40","28","12","-2"
"152080","University of Notre Dame","2019","First major","'14'","Engineering","Doctor's degree - research/scholarship","72","53","19","0","0","0","0","0","0","2","2","0","4","3","1","0","0","0","31","23","8","0","0","0","0","0","0","35","25","10","-2"
"152318","Rose-Hulman Institute of Technology","2019","First major","'14'","Engineering","Bachelor's degree","390","277","113","0","0","0","22","11","11","6","4","2","21","11","10","0","0","0","290","216","74","18","11","7","1","1","0","32","23","9","-2"
"152318","Rose-Hulman Institute of Technology","2019","First major","'14'","Engineering","Master's degree","22","16","6","0","0","0","0","0","0","0","0","0","2","2","0","0","0","0","13","9","4","0","0","0","0","0","0","7","5","2","-2"
"152318","Rose-Hulman Institute of Technology","2019","Second major","'14'","Engineering","Bachelor's degree","15","11","4","0","0","0","1","0","1","0","0","0","2","2","0","0","0","0","9","8","1","2","0","2","0","0","0","1","1","0","-2"
"152530","Taylor University","2019","First major","'14'","Engineering","Bachelor's degree","13","13","0","0","0","0","1","1","0","0","0","0","0","0","0","0","0","0","12","12","0","0","0","0","0","0","0","0","0","0","-2"
"152567","Trine University","2019","First major","'14'","Engineering","Bachelor's degree","142","119","23","0","0","0","1","1","0","1","1","0","6","6","0","1","1","0","123","103","20","1","1","0","0","0","0","9","6","3","-2"
"152567","Trine University","2019","First major","'14'","Engineering","Master's degree","0","0","0","0","0","0","0","0","0","0","0","0","0","0","0","0","0","0","0","0","0","0","0","0","0","0","0","0","0","0","-2"
"152600","Valparaiso University","2019","First major","'14'","Engineering","Bachelor's degree","125","102","23","0","0","0","4","4","0","2","2","0","9","8","1","0","0","0","87","69","18","1","1","0","4","4","0","18","14","4","-2"
"152637","Vincennes University","2019","First major","'14'","Engineering","Associate's degree","13","11","2","0","0","0","0","0","0","0","0","0","1","0","1","0","0","0","11","10","1","1","1","0","0","0","0","0","0","0","-2"
"153108","Central College","2019","First major","'14'","Engineering","Bachelor's degree","6","6","0","0","0","0","1","1","0","0","0","0","0","0","0","0","0","0","5","5","0","0","0","0","0","0","0","0","0","0","-2"
"153162","Cornell College","2019","First major","'14'","Engineering","Bachelor's degree","1","1","0","0","0","0","0","0","0","0","0","0","0","0","0","0","0","0","1","1","0","0","0","0","0","0","0","0","0","0","-2"
"153250","Dordt University","2019","First major","'14'","Engineering","Bachelor's degree","36","31","5","0","0","0","0","0","0","2","1","1","2","2","0","0","0","0","24","21","3","0","0","0","1","1","0","7","6","1","-2"
"153472","Indian Hills Community College","2019","First major","'14'","Engineering","Associate's degree","0","0","0","0","0","0","0","0","0","0","0","0","0","0","0","0","0","0","0","0","0","0","0","0","0","0","0","0","0","0","-2"
"153603","Iowa State University","2019","First major","'14'","Engineering","Bachelor's degree","1652","1382","270","3","2","1","56","45","11","21","18","3","56","44","12","3","3","0","1183","997","186","27","18","9","101","87","14","202","168","34","-2"
"153603","Iowa State University","2019","First major","'14'","Engineering","Master's degree","241","187","54","2","2","0","5","5","0","3","2","1","4","4","0","0","0","0","87","76","11","1","1","0","4","3","1","135","94","41","-2"
"153603","Iowa State University","2019","First major","'14'","Engineering","Doctor's degree - research/scholarship","134","110","24","0","0","0","5","5","0","1","1","0","0","0","0","0","0","0","21","18","3","0","0","0","1","0","1","106","86","20","-2"
"153603","Iowa State University","2019","Second major","'14'","Engineering","Master's degree","8","7","1","0","0","0","0","0","0","1","1","0","0","0","0","0","0","0","4","3","1","0","0","0","0","0","0","3","3","0","-2"
"153603","Iowa State University","2019","Second major","'14'","Engineering","Doctor's degree - research/scholarship","9","8","1","0","0","0","0","0","0","1","0","1","0","0","0","0","0","0","1","1","0","0","0","0","0","0","0","7","7","0","-2"
"153658","University of Iowa","2019","First major","'14'","Engineering","Bachelor's degree","451","324","127","0","0","0","21","14","7","10","6","4","33","21","12","1","1","0","321","240","81","11","6","5","5","4","1","49","32","17","-2"
"153658","University of Iowa","2019","First major","'14'","Engineering","Master's degree","41","30","11","0","0","0","0","0","0","1","0","1","4","2","2","0","0","0","31","25","6","1","0","1","1","1","0","3","2","1","-2"
"153658","University of Iowa","2019","First major","'14'","Engineering","Doctor's degree - research/scholarship","37","29","8","0","0","0","1","1","0","0","0","0","1","1","0","0","0","0","14","11","3","0","0","0","2","2","0","19","14","5","-2"
"153658","University of Iowa","2019","Second major","'14'","Engineering","Bachelor's degree","5","3","2","0","0","0","0","0","0","0","0","0","0","0","0","0","0","0","5","3","2","0","0","0","0","0","0","0","0","0","-2"
"153825","Loras College","2019","First major","'14'","Engineering","Bachelor's degree","6","3","3","0","0","0","0","0","0","0","0","0","0","0","0","0","0","0","6","3","3","0","0","0","0","0","0","0","0","0","-2"
"154004","Morningside College","2019","First major","'14'","Engineering","Bachelor's degree","2","2","0","0","0","0","0","0","0","0","0","0","1","1","0","0","0","0","1","1","0","0","0","0","0","0","0","0","0","0","-2"
"154022","Ashford University","2019","First major","'14'","Engineering","Bachelor's degree","0","0","0","0","0","0","0","0","0","0","0","0","0","0","0","0","0","0","0","0","0","0","0","0","0","0","0","0","0","0","-2"
"154095","University of Northern Iowa","2019","First major","'14'","Engineering","Bachelor's degree","0","0","0","0","0","0","0","0","0","0","0","0","0","0","0","0","0","0","0","0","0","0","0","0","0","0","0","0","0","0","-2"
"154095","University of Northern Iowa","2019","First major","'14'","Engineering","Master's degree","0","0","0","0","0","0","0","0","0","0","0","0","0","0","0","0","0","0","0","0","0","0","0","0","0","0","0","0","0","0","-2"
"154235","Saint Ambrose University","2019","First major","'14'","Engineering","Bachelor's degree","35","33","2","0","0","0","1","1","0","0","0","0","1","1","0","0","0","0","15","13","2","0","0","0","0","0","0","18","18","0","-2"
"154350","Simpson College","2019","First major","'14'","Engineering","Bachelor's degree","1","1","0","0","0","0","0","0","0","0","0","0","0","0","0","0","0","0","1","1","0","0","0","0","0","0","0","0","0","0","-2"
"154493","Upper Iowa University","2019","First major","'14'","Engineering","Bachelor's degree","0","0","0","0","0","0","0","0","0","0","0","0","0","0","0","0","0","0","0","0","0","0","0","0","0","0","0","0","0","0","-2"
"154493","Upper Iowa University","2019","Second major","'14'","Engineering","Bachelor's degree","1","1","0","0","0","0","0","0","0","0","0","0","0","0","0","0","0","0","1","1","0","0","0","0","0","0","0","0","0","0","-2"
"154527","Wartburg College","2019","First major","'14'","Engineering","Bachelor's degree","9","8","1","0","0","0","0","0","0","1","1","0","0","0","0","0","0","0","6","5","1","0","0","0","0","0","0","2","2","0","-2"
"154590","William Penn University","2019","First major","'14'","Engineering","Bachelor's degree","2","2","0","0","0","0","0","0","0","0","0","0","0","0","0","0","0","0","2","2","0","0","0","0","0","0","0","0","0","0","-2"
"154590","William Penn University","2019","Second major","'14'","Engineering","Bachelor's degree","1","1","0","0","0","0","0","0","0","0","0","0","0","0","0","0","0","0","1","1","0","0","0","0","0","0","0","0","0","0","-2"
"154642","Allen County Community College","2019","First major","'14'","Engineering","Associate's degree","5","2","3","0","0","0","0","0","0","0","0","0","0","0","0","0","0","0","5","2","3","0","0","0","0","0","0","0","0","0","-2"
"154697","Barton County Community College","2019","First major","'14'","Engineering","Associate's degree","0","0","0","0","0","0","0","0","0","0","0","0","0","0","0","0","0","0","0","0","0","0","0","0","0","0","0","0","0","0","-2"
"154712","Benedictine College","2019","First major","'14'","Engineering","Bachelor's degree","23","18","5","0","0","0","0","0","0","0","0","0","1","1","0","0","0","0","17","14","3","3","3","0","1","0","1","1","0","1","-2"
"154712","Benedictine College","2019","Second major","'14'","Engineering","Bachelor's degree","2","2","0","0","0","0","0","0","0","0","0","0","0","0","0","0","0","0","2","2","0","0","0","0","0","0","0","0","0","0","-2"
"154721","Bethany College","2019","First major","'14'","Engineering","Bachelor's degree","0","0","0","0","0","0","0","0","0","0","0","0","0","0","0","0","0","0","0","0","0","0","0","0","0","0","0","0","0","0","-2"
"154800","Butler Community College","2019","First major","'14'","Engineering","Associate's degree","13","12","1","0","0","0","1","1","0","0","0","0","0","0","0","0","0","0","7","6","1","0","0","0","1","1","0","4","4","0","-2"
"154934","Colby Community College","2019","First major","'14'","Engineering","Associate's degree","1","1","0","0","0","0","0","0","0","0","0","0","0","0","0","0","0","0","1","1","0","0","0","0","0","0","0","0","0","0","-2"
"154998","Dodge City Community College","2019","First major","'14'","Engineering","Associate's degree","5","4","1","0","0","0","0","0","0","1","1","0","3","2","1","0","0","0","1","1","0","0","0","0","0","0","0","0","0","0","-2"
"155052","Flint Hills Technical College","2019","First major","'14'","Engineering","Associate's degree","18","17","1","0","0","0","1","1","0","0","0","0","1","1","0","0","0","0","16","15","1","0","0","0","0","0","0","0","0","0","-2"
"155061","Fort Hays State University","2019","First major","'14'","Engineering","Bachelor's degree","8","7","1","0","0","0","0","0","0","0","0","0","0","0","0","0","0","0","7","6","1","0","0","0","1","1","0","0","0","0","-2"
"155104","Garden City Community College","2019","First major","'14'","Engineering","Associate's degree","6","6","0","0","0","0","0","0","0","1","1","0","3","3","0","0","0","0","2","2","0","0","0","0","0","0","0","0","0","0","-2"
"155186","Highland Community College","2019","First major","'14'","Engineering","Associate's degree","0","0","0","0","0","0","0","0","0","0","0","0","0","0","0","0","0","0","0","0","0","0","0","0","0","0","0","0","0","0","-2"
"155317","University of Kansas","2019","First major","'14'","Engineering","Bachelor's degree","368","283","85","0","0","0","20","13","7","8","7","1","22","15","7","0","0","0","256","196","60","14","12","2","2","2","0","46","38","8","-2"
"155317","University of Kansas","2019","First major","'14'","Engineering","Master's degree","90","64","26","0","0","0","3","2","1","4","2","2","3","2","1","0","0","0","39","29","10","2","1","1","1","1","0","38","27","11","-2"
"155317","University of Kansas","2019","First major","'14'","Engineering","Doctor's degree - research/scholarship","41","30","11","0","0","0","1","1","0","0","0","0","0","0","0","0","0","0","10","6","4","1","1","0","2","1","1","27","21","6","-2"
"155399","Kansas State University","2019","First major","'14'","Engineering","Bachelor's degree","521","415","106","4","3","1","6","3","3","4","2","2","21","18","3","0","0","0","415","329","86","9","6","3","7","6","1","55","48","7","-2"
"155399","Kansas State University","2019","First major","'14'","Engineering","Master's degree","77","62","15","0","0","0","2","2","0","4","3","1","1","1","0","0","0","0","47","39","8","3","2","1","2","2","0","18","13","5","-2"
"155399","Kansas State University","2019","First major","'14'","Engineering","Doctor's degree - research/scholarship","35","24","11","0","0","0","1","1","0","1","0","1","0","0","0","0","0","0","13","9","4","0","0","0","1","1","0","19","13","6","-2"
"155414","Kansas Wesleyan University","2019","First major","'14'","Engineering","Bachelor's degree","5","3","2","0","0","0","0","0","0","0","0","0","0","0","0","0","0","0","5","3","2","0","0","0","0","0","0","0","0","0","-2"
"155627","Ottawa University-Ottawa","2019","First major","'14'","Engineering","Bachelor's degree","6","6","0","0","0","0","0","0","0","0","0","0","0","0","0","0","0","0","6","6","0","0","0","0","0","0","0","0","0","0","-2"
"156082","Washburn University","2019","First major","'14'","Engineering","Associate's degree","1","1","0","0","0","0","0","0","0","0","0","0","0","0","0","0","0","0","1","1","0","0","0","0","0","0","0","0","0","0","-2"
"156125","Wichita State University","2019","First major","'14'","Engineering","Bachelor's degree","275","238","37","2","2","0","26","15","11","14","9","5","21","18","3","0","0","0","124","106","18","8","8","0","8","8","0","72","72","0","-2"
"156125","Wichita State University","2019","First major","'14'","Engineering","Master's degree","113","91","22","1","0","1","8","7","1","4","4","0","1","1","0","0","0","0","32","27","5","0","0","0","1","1","0","66","51","15","-2"
"156125","Wichita State University","2019","First major","'14'","Engineering","Doctor's degree - research/scholarship","17","15","2","1","1","0","0","0","0","0","0","0","0","0","0","0","0","0","1","1","0","0","0","0","0","0","0","15","13","2","-2"
"156213","Asbury University","2019","First major","'14'","Engineering","Bachelor's degree","1","1","0","0","0","0","0","0","0","0","0","0","0","0","0","0","0","0","0","0","0","0","0","0","1","1","0","0","0","0","-2"
"156286","Bellarmine University","2019","First major","'14'","Engineering","Bachelor's degree","3","2","1","0","0","0","0","0","0","0","0","0","0","0","0","0","0","0","3","2","1","0","0","0","0","0","0","0","0","0","-2"
"156356","Brescia University","2019","First major","'14'","Engineering","Associate's degree","0","0","0","0","0","0","0","0","0","0","0","0","0","0","0","0","0","0","0","0","0","0","0","0","0","0","0","0","0","0","-2"
"156392","Bluegrass Community and Technical College","2019","First major","'14'","Engineering","Associate's degree","0","0","0","0","0","0","0","0","0","0","0","0","0","0","0","0","0","0","0","0","0","0","0","0","0","0","0","0","0","0","-2"
"156541","University of the Cumberlands","2019","First major","'14'","Engineering","Bachelor's degree","0","0","0","0","0","0","0","0","0","0","0","0","0","0","0","0","0","0","0","0","0","0","0","0","0","0","0","0","0","0","-2"
"157085","University of Kentucky","2019","First major","'14'","Engineering","Bachelor's degree","528","418","110","0","0","0","16","13","3","21","15","6","18","17","1","1","1","0","385","301","84","17","14","3","15","13","2","55","44","11","-2"
"157085","University of Kentucky","2019","First major","'14'","Engineering","Master's degree","72","55","17","0","0","0","2","2","0","0","0","0","3","3","0","0","0","0","42","32","10","2","1","1","6","5","1","17","12","5","-2"
"157085","University of Kentucky","2019","First major","'14'","Engineering","Doctor's degree - research/scholarship","51","40","11","0","0","0","1","0","1","1","0","1","0","0","0","0","0","0","15","14","1","0","0","0","3","3","0","31","23","8","-2"
"157216","Lindsey Wilson College","2019","First major","'14'","Engineering","Associate's degree","2","1","1","0","0","0","0","0","0","0","0","0","0","0","0","0","0","0","1","1","0","0","0","0","1","0","1","0","0","0","-2"
"157289","University of Louisville","2019","First major","'14'","Engineering","Bachelor's degree","411","318","93","0","0","0","27","24","3","16","13","3","17","12","5","0","0","0","325","250","75","18","12","6","1","1","0","7","6","1","-2"
"157289","University of Louisville","2019","First major","'14'","Engineering","Master's degree","186","147","39","0","0","0","9","9","0","3","3","0","5","3","2","0","0","0","150","119","31","2","1","1","1","1","0","16","11","5","-2"
"157289","University of Louisville","2019","First major","'14'","Engineering","Doctor's degree - research/scholarship","24","21","3","0","0","0","4","3","1","0","0","0","0","0","0","0","0","0","1","1","0","0","0","0","0","0","0","19","17","2","-2"
"157386","Morehead State University","2019","First major","'14'","Engineering","Bachelor's degree","0","0","0","0","0","0","0","0","0","0","0","0","0","0","0","0","0","0","0","0","0","0","0","0","0","0","0","0","0","0","-2"
"157386","Morehead State University","2019","First major","'14'","Engineering","Master's degree","5","4","1","0","0","0","0","0","0","0","0","0","0","0","0","0","0","0","2","1","1","0","0","0","0","0","0","3","3","0","-2"
"157401","Murray State University","2019","First major","'14'","Engineering","Bachelor's degree","34","29","5","0","0","0","0","0","0","0","0","0","0","0","0","0","0","0","28","26","2","1","0","1","1","0","1","4","3","1","-2"
"157951","Western Kentucky University","2019","First major","'14'","Engineering","Bachelor's degree","104","91","13","0","0","0","1","1","0","2","2","0","3","3","0","0","0","0","72","59","13","1","1","0","1","1","0","24","24","0","-2"
"158431","Bossier Parish Community College","2019","First major","'14'","Engineering","Associate's degree","12","11","1","0","0","0","1","0","1","2","2","0","2","2","0","0","0","0","5","5","0","1","1","0","0","0","0","1","1","0","-2"
"159391","Louisiana State University and Agricultural & Mechanical College","2019","First major","'14'","Engineering","Bachelor's degree","883","660","223","0","0","0","53","40","13","34","22","12","50","37","13","0","0","0","643","475","168","13","8","5","9","6","3","81","72","9","-2"
"159391","Louisiana State University and Agricultural & Mechanical College","2019","First major","'14'","Engineering","Master's degree","67","48","19","0","0","0","5","4","1","1","0","1","1","1","0","0","0","0","20","15","5","0","0","0","0","0","0","40","28","12","-2"
"159391","Louisiana State University and Agricultural & Mechanical College","2019","First major","'14'","Engineering","Doctor's degree - research/scholarship","52","40","12","0","0","0","0","0","0","0","0","0","0","0","0","0","0","0","12","7","5","1","0","1","1","1","0","38","32","6","-2"
"159391","Louisiana State University and Agricultural & Mechanical College","2019","Second major","'14'","Engineering","Bachelor's degree","1","0","1","0","0","0","0","0","0","0","0","0","0","0","0","0","0","0","1","0","1","0","0","0","0","0","0","0","0","0","-2"
"159647","Louisiana Tech University","2019","First major","'14'","Engineering","Bachelor's degree","256","196","60","0","0","0","4","3","1","12","9","3","15","13","2","0","0","0","186","141","45","8","6","2","23","18","5","8","6","2","-2"
"159647","Louisiana Tech University","2019","First major","'14'","Engineering","Master's degree","29","23","6","0","0","0","0","0","0","0","0","0","0","0","0","0","0","0","8","7","1","0","0","0","0","0","0","21","16","5","-2"
"159647","Louisiana Tech University","2019","First major","'14'","Engineering","Doctor's degree - research/scholarship","20","14","6","0","0","0","0","0","0","0","0","0","2","2","0","0","0","0","3","1","2","0","0","0","0","0","0","15","11","4","-2"
"159717","McNeese State University","2019","First major","'14'","Engineering","Bachelor's degree","109","79","30","0","0","0","3","2","1","6","5","1","5","5","0","0","0","0","71","49","22","2","1","1","0","0","0","22","17","5","-2"
"159717","McNeese State University","2019","First major","'14'","Engineering","Master's degree","8","5","3","0","0","0","1","0","1","0","0","0","0","0","0","0","0","0","2","2","0","0","0","0","0","0","0","5","3","2","-2"
"159939","University of New Orleans","2019","First major","'14'","Engineering","Bachelor's degree","147","129","18","0","0","0","16","15","1","5","4","1","11","9","2","0","0","0","86","76","10","4","2","2","1","1","0","24","22","2","-2"
"159939","University of New Orleans","2019","First major","'14'","Engineering","Master's degree","18","13","5","0","0","0","0","0","0","0","0","0","0","0","0","0","0","0","10","8","2","1","1","0","1","1","0","6","3","3","-2"
"159939","University of New Orleans","2019","First major","'14'","Engineering","Doctor's degree - research/scholarship","8","8","0","0","0","0","0","0","0","0","0","0","0","0","0","0","0","0","3","3","0","0","0","0","0","0","0","5","5","0","-2"
"160621","Southern University and A & M College","2019","First major","'14'","Engineering","Bachelor's degree","53","40","13","0","0","0","0","0","0","50","37","13","1","1","0","0","0","0","2","2","0","0","0","0","0","0","0","0","0","0","-2"
"160621","Southern University and A & M College","2019","First major","'14'","Engineering","Master's degree","5","5","0","0","0","0","2","2","0","3","3","0","0","0","0","0","0","0","0","0","0","0","0","0","0","0","0","0","0","0","-2"
"160658","University of Louisiana at Lafayette","2019","First major","'14'","Engineering","Bachelor's degree","326","269","57","0","0","0","14","10","4","16","15","1","11","9","2","0","0","0","241","201","40","5","5","0","11","9","2","28","20","8","-2"
"160658","University of Louisiana at Lafayette","2019","First major","'14'","Engineering","Master's degree","35","29","6","0","0","0","2","2","0","3","3","0","1","1","0","0","0","0","9","6","3","0","0","0","0","0","0","20","17","3","-2"
"160658","University of Louisiana at Lafayette","2019","First major","'14'","Engineering","Doctor's degree - research/scholarship","10","7","3","0","0","0","2","0","2","0","0","0","0","0","0","0","0","0","2","2","0","0","0","0","2","1","1","4","4","0","-2"
"160755","Tulane University of Louisiana","2019","First major","'14'","Engineering","Bachelor's degree","67","35","32","0","0","0","4","2","2","4","1","3","2","2","0","0","0","0","45","22","23","5","3","2","1","0","1","6","5","1","-2"
"160755","Tulane University of Louisiana","2019","First major","'14'","Engineering","Master's degree","10","5","5","0","0","0","1","1","0","0","0","0","1","0","1","0","0","0","4","2","2","1","0","1","0","0","0","3","2","1","-2"
"160755","Tulane University of Louisiana","2019","First major","'14'","Engineering","Doctor's degree - research/scholarship","11","8","3","0","0","0","0","0","0","0","0","0","0","0","0","0","0","0","3","2","1","1","1","0","1","1","0","6","4","2","-2"
"160977","Bates College","2019","First major","'14'","Engineering","Bachelor's degree","2","2","0","0","0","0","0","0","0","0","0","0","0","0","0","0","0","0","1","1","0","0","0","0","0","0","0","1","1","0","-2"
"160977","Bates College","2019","Second major","'14'","Engineering","Bachelor's degree","1","1","0","0","0","0","0","0","0","0","0","0","0","0","0","0","0","0","1","1","0","0","0","0","0","0","0","0","0","0","-2"
"161192","Kennebec Valley Community College","2019","First major","'14'","Engineering","Associate's degree","2","2","0","0","0","0","0","0","0","0","0","0","0","0","0","0","0","0","2","2","0","0","0","0","0","0","0","0","0","0","-2"
"161253","University of Maine","2019","First major","'14'","Engineering","Bachelor's degree","251","186","65","0","0","0","6","4","2","6","3","3","7","4","3","0","0","0","211","159","52","1","1","0","10","8","2","10","7","3","-2"
"161253","University of Maine","2019","First major","'14'","Engineering","Master's degree","30","24","6","0","0","0","1","0","1","0","0","0","0","0","0","0","0","0","19","14","5","0","0","0","3","3","0","7","7","0","-2"
"161253","University of Maine","2019","First major","'14'","Engineering","Doctor's degree - research/scholarship","8","4","4","0","0","0","0","0","0","0","0","0","0","0","0","0","0","0","4","1","3","0","0","0","1","1","0","3","2","1","-2"
"161299","Maine Maritime Academy","2019","First major","'14'","Engineering","Bachelor's degree","93","91","2","0","0","0","1","1","0","1","1","0","0","0","0","1","1","0","82","80","2","0","0","0","8","8","0","0","0","0","-2"
"161545","Southern Maine Community College","2019","First major","'14'","Engineering","Associate's degree","7","6","1","0","0","0","0","0","0","2","1","1","0","0","0","0","0","0","5","5","0","0","0","0","0","0","0","0","0","0","-2"
"161554","University of Southern Maine","2019","First major","'14'","Engineering","Bachelor's degree","26","24","2","0","0","0","1","1","0","0","0","0","1","1","0","0","0","0","21","19","2","0","0","0","1","1","0","2","2","0","-2"
"161767","Anne Arundel Community College","2019","First major","'14'","Engineering","Associate's degree","61","47","14","0","0","0","3","3","0","4","4","0","4","3","1","0","0","0","41","32","9","1","1","0","7","4","3","1","0","1","-2"
"161864","Baltimore City Community College","2019","First major","'14'","Engineering","Associate's degree","7","5","2","0","0","0","0","0","0","2","2","0","0","0","0","0","0","0","0","0","0","0","0","0","0","0","0","5","3","2","-2"
"162061","Capitol Technology University","2019","First major","'14'","Engineering","Bachelor's degree","40","36","4","0","0","0","0","0","0","6","3","3","1","1","0","0","0","0","31","30","1","2","2","0","0","0","0","0","0","0","-2"
"162061","Capitol Technology University","2019","First major","'14'","Engineering","Master's degree","2","1","1","0","0","0","1","1","0","1","0","1","0","0","0","0","0","0","0","0","0","0","0","0","0","0","0","0","0","0","-2"
"162104","Cecil College","2019","First major","'14'","Engineering","Associate's degree","25","19","6","0","0","0","0","0","0","1","1","0","0","0","0","0","0","0","21","15","6","0","0","0","3","3","0","0","0","0","-2"
"162122","College of Southern Maryland","2019","First major","'14'","Engineering","Associate's degree","48","40","8","0","0","0","3","2","1","7","6","1","2","0","2","0","0","0","30","26","4","5","5","0","1","1","0","0","0","0","-2"
"162210","Washington Adventist University","2019","First major","'14'","Engineering","Associate's degree","0","0","0","0","0","0","0","0","0","0","0","0","0","0","0","0","0","0","0","0","0","0","0","0","0","0","0","0","0","0","-2"
"162557","Frederick Community College","2019","First major","'14'","Engineering","Associate's degree","0","0","0","0","0","0","0","0","0","0","0","0","0","0","0","0","0","0","0","0","0","0","0","0","0","0","0","0","0","0","-2"
"162584","Frostburg State University","2019","First major","'14'","Engineering","Bachelor's degree","43","41","2","0","0","0","1","1","0","12","12","0","4","4","0","0","0","0","21","19","2","0","0","0","4","4","0","1","1","0","-2"
"162609","Garrett College","2019","First major","'14'","Engineering","Associate's degree","1","1","0","0","0","0","0","0","0","0","0","0","0","0","0","0","0","0","1","1","0","0","0","0","0","0","0","0","0","0","-2"
"162690","Hagerstown Community College","2019","First major","'14'","Engineering","Associate's degree","11","8","3","0","0","0","1","1","0","2","1","1","0","0","0","0","0","0","7","5","2","1","1","0","0","0","0","0","0","0","-2"
"162706","Harford Community College","2019","First major","'14'","Engineering","Associate's degree","17","13","4","0","0","0","0","0","0","0","0","0","1","1","0","0","0","0","15","11","4","1","1","0","0","0","0","0","0","0","-2"
"162779","Howard Community College","2019","First major","'14'","Engineering","Associate's degree","22","17","5","0","0","0","1","1","0","3","3","0","3","2","1","0","0","0","11","9","2","1","1","0","0","0","0","3","1","2","-2"
"162928","Johns Hopkins University","2019","First major","'14'","Engineering","Bachelor's degree","292","183","109","0","0","0","89","58","31","11","4","7","34","25","9","0","0","0","91","56","35","19","13","6","9","5","4","39","22","17","-2"
"162928","Johns Hopkins University","2019","First major","'14'","Engineering","Master's degree","751","530","221","0","0","0","84","66","18","32","22","10","41","25","16","0","0","0","336","248","88","26","14","12","36","27","9","196","128","68","-2"
"162928","Johns Hopkins University","2019","First major","'14'","Engineering","Doctor's degree - research/scholarship","90","70","20","0","0","0","11","6","5","3","2","1","3","0","3","0","0","0","30","27","3","2","2","0","1","1","0","40","32","8","-2"
"162928","Johns Hopkins University","2019","Second major","'14'","Engineering","Bachelor's degree","6","5","1","0","0","0","1","1","0","0","0","0","0","0","0","0","0","0","3","2","1","2","2","0","0","0","0","0","0","0","-2"
"163046","Loyola University Maryland","2019","First major","'14'","Engineering","Bachelor's degree","26","20","6","0","0","0","1","0","1","3","3","0","3","3","0","0","0","0","19","14","5","0","0","0","0","0","0","0","0","0","-2"
"163046","Loyola University Maryland","2019","First major","'14'","Engineering","Master's degree","0","0","0","0","0","0","0","0","0","0","0","0","0","0","0","0","0","0","0","0","0","0","0","0","0","0","0","0","0","0","-2"
"163204","University of Maryland Global Campus","2019","First major","'14'","Engineering","Master's degree","8","6","2","0","0","0","4","3","1","1","1","0","1","1","0","0","0","0","2","1","1","0","0","0","0","0","0","0","0","0","-2"
"163268","University of Maryland-Baltimore County","2019","First major","'14'","Engineering","Bachelor's degree","263","197","66","0","0","0","40","29","11","35","22","13","13","13","0","1","0","1","143","110","33","8","6","2","13","10","3","10","7","3","-2"
"163268","University of Maryland-Baltimore County","2019","First major","'14'","Engineering","Master's degree","41","30","11","0","0","0","4","3","1","4","3","1","0","0","0","0","0","0","15","12","3","2","2","0","1","1","0","15","9","6","-2"
"163268","University of Maryland-Baltimore County","2019","First major","'14'","Engineering","Doctor's degree - research/scholarship","18","15","3","0","0","0","0","0","0","3","2","1","0","0","0","0","0","0","6","5","1","0","0","0","0","0","0","9","8","1","-2"
"163286","University of Maryland-College Park","2019","First major","'14'","Engineering","Bachelor's degree","1032","819","213","0","0","0","194","160","34","83","66","17","78","59","19","1","1","0","563","449","114","46","37","9","12","9","3","55","38","17","-2"
"163286","University of Maryland-College Park","2019","First major","'14'","Engineering","Master's degree","574","449","125","0","0","0","40","30","10","22","17","5","24","22","2","0","0","0","132","106","26","6","6","0","7","7","0","343","261","82","-2"
"163286","University of Maryland-College Park","2019","First major","'14'","Engineering","Doctor's degree - research/scholarship","165","129","36","0","0","0","12","9","3","4","4","0","6","4","2","0","0","0","43","37","6","3","2","1","3","2","1","94","71","23","-2"
"163286","University of Maryland-College Park","2019","Second major","'14'","Engineering","Bachelor's degree","1","1","0","0","0","0","1","1","0","0","0","0","0","0","0","0","0","0","0","0","0","0","0","0","0","0","0","0","0","0","-2"
"163338","University of Maryland Eastern Shore","2019","First major","'14'","Engineering","Bachelor's degree","22","19","3","0","0","0","0","0","0","8","7","1","1","1","0","0","0","0","8","8","0","2","1","1","0","0","0","3","2","1","-2"
"163426","Montgomery College","2019","First major","'14'","Engineering","Associate's degree","122","84","38","0","0","0","21","14","7","37","22","15","19","13","6","0","0","0","21","17","4","2","2","0","2","1","1","20","15","5","-2"
"163453","Morgan State University","2019","First major","'14'","Engineering","Bachelor's degree","175","148","27","0","0","0","2","2","0","68","47","21","4","2","2","0","0","0","3","3","0","6","6","0","4","3","1","88","85","3","-2"
"163453","Morgan State University","2019","First major","'14'","Engineering","Master's degree","19","13","6","0","0","0","0","0","0","16","10","6","1","1","0","0","0","0","0","0","0","1","1","0","0","0","0","1","1","0","-2"
"163453","Morgan State University","2019","First major","'14'","Engineering","Doctor's degree - research/scholarship","9","7","2","0","0","0","0","0","0","7","6","1","0","0","0","0","0","0","0","0","0","0","0","0","0","0","0","2","1","1","-2"
"163657","Prince George's Community College","2019","First major","'14'","Engineering","Associate's degree","18","15","3","0","0","0","1","1","0","11","9","2","3","2","1","0","0","0","2","2","0","0","0","0","0","0","0","1","1","0","-2"
"164155","United States Naval Academy","2019","First major","'14'","Engineering","Bachelor's degree","393","300","93","0","0","0","30","22","8","22","15","7","39","33","6","0","0","0","257","196","61","34","25","9","5","4","1","6","5","1","-2"
"164155","United States Naval Academy","2019","Second major","'14'","Engineering","Bachelor's degree","5","3","2","0","0","0","0","0","0","0","0","0","0","0","0","0","0","0","4","2","2","1","1","0","0","0","0","0","0","0","-2"
"164775","Berkshire Community College","2019","First major","'14'","Engineering","Associate's degree","12","10","2","0","0","0","2","1","1","0","0","0","2","2","0","0","0","0","4","3","1","0","0","0","1","1","0","3","3","0","-2"
"164988","Boston University","2019","First major","'14'","Engineering","Bachelor's degree","389","241","148","0","0","0","71","45","26","14","7","7","41","23","18","0","0","0","132","80","52","12","7","5","17","11","6","102","68","34","-2"
"164988","Boston University","2019","First major","'14'","Engineering","Master's degree","327","228","99","0","0","0","25","16","9","2","2","0","12","7","5","0","0","0","76","48","28","5","2","3","8","6","2","199","147","52","-2"
"164988","Boston University","2019","First major","'14'","Engineering","Doctor's degree - research/scholarship","59","43","16","0","0","0","6","2","4","0","0","0","3","3","0","0","0","0","10","4","6","1","1","0","3","3","0","36","30","6","-2"
"164988","Boston University","2019","Second major","'14'","Engineering","Bachelor's degree","5","2","3","0","0","0","2","1","1","0","0","0","0","0","0","0","0","0","3","1","2","0","0","0","0","0","0","0","0","0","-2"
"165033","Bristol Community College","2019","First major","'14'","Engineering","Associate's degree","26","24","2","0","0","0","0","0","0","0","0","0","3","3","0","0","0","0","19","18","1","3","2","1","1","1","0","0","0","0","-2"
"165112","Bunker Hill Community College","2019","First major","'14'","Engineering","Associate's degree","43","32","11","0","0","0","7","6","1","3","3","0","8","4","4","0","0","0","4","2","2","2","1","1","3","3","0","16","13","3","-2"
"165194","Cape Cod Community College","2019","First major","'14'","Engineering","Associate's degree","4","2","2","0","0","0","2","1","1","1","0","1","1","1","0","0","0","0","0","0","0","0","0","0","0","0","0","0","0","0","-2"
"165644","Eastern Nazarene College","2019","First major","'14'","Engineering","Bachelor's degree","1","1","0","0","0","0","0","0","0","0","0","0","0","0","0","0","0","0","1","1","0","0","0","0","0","0","0","0","0","0","-2"
"165699","Endicott College","2019","First major","'14'","Engineering","Bachelor's degree","6","3","3","0","0","0","1","0","1","0","0","0","0","0","0","0","0","0","5","3","2","0","0","0","0","0","0","0","0","0","-2"
"165981","Greenfield Community College","2019","First major","'14'","Engineering","Associate's degree","12","11","1","0","0","0","0","0","0","0","0","0","1","1","0","0","0","0","10","9","1","0","0","0","1","1","0","0","0","0","-2"
"166027","Harvard University","2019","First major","'14'","Engineering","Bachelor's degree","85","51","34","0","0","0","12","4","8","8","7","1","7","4","3","0","0","0","33","18","15","9","5","4","1","1","0","15","12","3","-2"
"166027","Harvard University","2019","First major","'14'","Engineering","Master's degree","137","101","36","0","0","0","24","22","2","2","2","0","9","6","3","0","0","0","50","39","11","1","0","1","6","4","2","45","28","17","-2"
"166027","Harvard University","2019","First major","'14'","Engineering","Doctor's degree - research/scholarship","52","34","18","0","0","0","11","7","4","0","0","0","3","2","1","0","0","0","14","6","8","1","0","1","2","1","1","21","18","3","-2"
"166133","Holyoke Community College","2019","First major","'14'","Engineering","Associate's degree","26","24","2","0","0","0","0","0","0","0","0","0","5","5","0","0","0","0","18","16","2","1","1","0","1","1","0","1","1","0","-2"
"166513","University of Massachusetts-Lowell","2019","First major","'14'","Engineering","Bachelor's degree","585","507","78","0","0","0","67","58","9","42","37","5","42","36","6","0","0","0","343","302","41","12","8","4","22","18","4","57","48","9","-2"
"166513","University of Massachusetts-Lowell","2019","First major","'14'","Engineering","Master's degree","214","159","55","0","0","0","29","17","12","7","6","1","12","9","3","0","0","0","80","68","12","4","3","1","4","2","2","78","54","24","-2"
"166513","University of Massachusetts-Lowell","2019","First major","'14'","Engineering","Doctor's degree - research/scholarship","44","30","14","0","0","0","1","1","0","0","0","0","0","0","0","0","0","0","16","10","6","0","0","0","0","0","0","27","19","8","-2"
"166629","University of Massachusetts-Amherst","2019","First major","'14'","Engineering","Bachelor's degree","484","394","90","0","0","0","63","49","14","19","18","1","19","14","5","0","0","0","326","276","50","4","2","2","26","19","7","27","16","11","-2"
"166629","University of Massachusetts-Amherst","2019","First major","'14'","Engineering","Master's degree","163","113","50","0","0","0","6","4","2","2","1","1","1","0","1","0","0","0","49","41","8","1","0","1","11","8","3","93","59","34","-2"
"166629","University of Massachusetts-Amherst","2019","First major","'14'","Engineering","Doctor's degree - research/scholarship","67","47","20","0","0","0","6","4","2","2","1","1","1","1","0","0","0","0","21","13","8","1","0","1","2","2","0","34","26","8","-2"
"166638","University of Massachusetts-Boston","2019","First major","'14'","Engineering","Bachelor's degree","22","21","1","0","0","0","5","4","1","5","5","0","2","2","0","0","0","0","7","7","0","0","0","0","2","2","0","1","1","0","-2"
"166683","Massachusetts Institute of Technology","2019","First major","'14'","Engineering","Bachelor's degree","443","216","227","0","0","0","93","28","65","30","17","13","69","47","22","0","0","0","178","89","89","31","16","15","9","3","6","33","16","17","-2"
"166683","Massachusetts Institute of Technology","2019","First major","'14'","Engineering","Master's degree","575","414","161","0","0","0","60","41","19","13","8","5","24","15","9","0","0","0","182","133","49","17","12","5","26","16","10","253","189","64","-2"
"166683","Massachusetts Institute of Technology","2019","First major","'14'","Engineering","Doctor's degree - research/scholarship","325","236","89","0","0","0","38","24","14","4","4","0","19","15","4","0","0","0","84","64","20","3","2","1","17","11","6","160","116","44","-2"
"166683","Massachusetts Institute of Technology","2019","Second major","'14'","Engineering","Bachelor's degree","7","4","3","0","0","0","2","1","1","0","0","0","1","1","0","0","0","0","3","1","2","0","0","0","0","0","0","1","1","0","-2"
"166692","Massachusetts Maritime Academy","2019","First major","'14'","Engineering","Bachelor's degree","167","152","15","0","0","0","2","1","1","1","0","1","5","4","1","0","0","0","146","136","10","6","4","2","7","7","0","0","0","0","-2"
"166823","Massasoit Community College","2019","First major","'14'","Engineering","Associate's degree","10","9","1","0","0","0","1","1","0","5","4","1","0","0","0","0","0","0","4","4","0","0","0","0","0","0","0","0","0","0","-2"
"166850","Merrimack College","2019","First major","'14'","Engineering","Associate's degree","0","0","0","0","0","0","0","0","0","0","0","0","0","0","0","0","0","0","0","0","0","0","0","0","0","0","0","0","0","0","-2"
"166850","Merrimack College","2019","First major","'14'","Engineering","Bachelor's degree","66","51","15","0","0","0","1","1","0","1","1","0","4","2","2","0","0","0","49","39","10","0","0","0","2","2","0","9","6","3","-2"
"166850","Merrimack College","2019","First major","'14'","Engineering","Master's degree","12","9","3","0","0","0","0","0","0","1","1","0","0","0","0","0","0","0","7","5","2","0","0","0","2","1","1","2","2","0","-2"
"166887","Middlesex Community College","2019","First major","'14'","Engineering","Associate's degree","2","2","0","0","0","0","0","0","0","0","0","0","0","0","0","0","0","0","2","2","0","0","0","0","0","0","0","0","0","0","-2"
"167312","North Shore Community College","2019","First major","'14'","Engineering","Associate's degree","12","10","2","0","0","0","1","1","0","0","0","0","4","2","2","0","0","0","7","7","0","0","0","0","0","0","0","0","0","0","-2"
"167358","Northeastern University","2019","First major","'14'","Engineering","Bachelor's degree","806","577","229","0","0","0","94","63","31","14","7","7","57","40","17","0","0","0","447","317","130","35","22","13","28","22","6","131","106","25","-2"
"167358","Northeastern University","2019","First major","'14'","Engineering","Master's degree","1343","989","354","0","0","0","41","28","13","7","6","1","24","17","7","0","0","0","163","120","43","10","7","3","13","12","1","1085","799","286","-2"
"167358","Northeastern University","2019","First major","'14'","Engineering","Doctor's degree - research/scholarship","82","59","23","0","0","0","2","1","1","3","2","1","3","2","1","0","0","0","18","12","6","1","1","0","1","1","0","54","40","14","-2"
"167534","Quinsigamond Community College","2019","First major","'14'","Engineering","Associate's degree","36","30","6","0","0","0","5","4","1","2","1","1","4","2","2","0","0","0","21","20","1","1","1","0","2","2","0","1","0","1","-2"
"167631","Roxbury Community College","2019","First major","'14'","Engineering","Associate's degree","2","1","1","0","0","0","0","0","0","0","0","0","1","1","0","0","0","0","0","0","0","1","0","1","0","0","0","0","0","0","-2"
"167792","Bard College at Simon's Rock","2019","First major","'14'","Engineering","Bachelor's degree","4","2","2","0","0","0","1","0","1","0","0","0","0","0","0","0","0","0","1","1","0","0","0","0","1","1","0","1","0","1","-2"
"167835","Smith College","2019","First major","'14'","Engineering","Bachelor's degree","36","0","36","0","0","0","5","0","5","2","0","2","4","0","4","0","0","0","14","0","14","1","0","1","0","0","0","10","0","10","-2"
"167835","Smith College","2019","Second major","'14'","Engineering","Bachelor's degree","3","0","3","0","0","0","0","0","0","0","0","0","1","0","1","0","0","0","2","0","2","0","0","0","0","0","0","0","0","0","-2"
"167905","Springfield Technical Community College","2019","First major","'14'","Engineering","Associate's degree","22","16","6","0","0","0","2","1","1","5","3","2","2","1","1","0","0","0","11","9","2","1","1","0","1","1","0","0","0","0","-2"
"167987","University of Massachusetts-Dartmouth","2019","First major","'14'","Engineering","Bachelor's degree","171","143","28","0","0","0","11","7","4","18","16","2","13","12","1","0","0","0","113","93","20","3","3","0","8","8","0","5","4","1","-2"
"167987","University of Massachusetts-Dartmouth","2019","First major","'14'","Engineering","Master's degree","28","26","2","0","0","0","0","0","0","0","0","0","0","0","0","0","0","0","16","15","1","0","0","0","0","0","0","12","11","1","-2"
"167987","University of Massachusetts-Dartmouth","2019","First major","'14'","Engineering","Doctor's degree - research/scholarship","8","5","3","0","0","0","0","0","0","0","0","0","0","0","0","0","0","0","2","1","1","1","1","0","0","0","0","5","3","2","-2"
"167987","University of Massachusetts-Dartmouth","2019","Second major","'14'","Engineering","Bachelor's degree","4","3","1","0","0","0","0","0","0","0","0","0","0","0","0","0","0","0","3","2","1","0","0","0","0","0","0","1","1","0","-2"
"167996","Stonehill College","2019","First major","'14'","Engineering","Bachelor's degree","0","0","0","0","0","0","0","0","0","0","0","0","0","0","0","0","0","0","0","0","0","0","0","0","0","0","0","0","0","0","-2"
"168005","Suffolk University","2019","First major","'14'","Engineering","Bachelor's degree","15","15","0","0","0","0","0","0","0","1","1","0","4","4","0","0","0","0","3","3","0","0","0","0","0","0","0","7","7","0","-2"
"168148","Tufts University","2019","First major","'14'","Engineering","Bachelor's degree","170","118","52","0","0","0","26","17","9","2","2","0","8","8","0","0","0","0","104","71","33","1","0","1","7","5","2","22","15","7","-2"
"168148","Tufts University","2019","First major","'14'","Engineering","Master's degree","107","67","40","0","0","0","10","6","4","0","0","0","2","1","1","0","0","0","43","29","14","3","1","2","1","0","1","48","30","18","-2"
"168148","Tufts University","2019","First major","'14'","Engineering","Doctor's degree - research/scholarship","32","16","16","0","0","0","3","2","1","0","0","0","2","0","2","0","0","0","11","5","6","0","0","0","2","2","0","14","7","7","-2"
"168148","Tufts University","2019","Second major","'14'","Engineering","Bachelor's degree","6","5","1","0","0","0","0","0","0","0","0","0","1","1","0","0","0","0","4","3","1","1","1","0","0","0","0","0","0","0","-2"
"168227","Wentworth Institute of Technology","2019","First major","'14'","Engineering","Bachelor's degree","352","283","69","0","0","0","17","13","4","11","9","2","6","5","1","0","0","0","235","193","42","35","30","5","21","13","8","27","20","7","-2"
"168227","Wentworth Institute of Technology","2019","First major","'14'","Engineering","Master's degree","1","1","0","0","0","0","0","0","0","0","0","0","0","0","0","0","0","0","1","1","0","0","0","0","0","0","0","0","0","0","-2"
"168254","Western New England University","2019","First major","'14'","Engineering","Bachelor's degree","138","114","24","1","1","0","6","5","1","3","2","1","9","7","2","0","0","0","106","87","19","0","0","0","4","3","1","9","9","0","-2"
"168254","Western New England University","2019","First major","'14'","Engineering","Master's degree","38","34","4","0","0","0","1","1","0","1","1","0","2","2","0","0","0","0","16","14","2","0","0","0","2","2","0","16","14","2","-2"
"168421","Worcester Polytechnic Institute","2019","First major","'14'","Engineering","Bachelor's degree","715","456","259","3","1","2","30","17","13","13","9","4","67","33","34","0","0","0","488","320","168","20","10","10","23","13","10","71","53","18","-2"
"168421","Worcester Polytechnic Institute","2019","First major","'14'","Engineering","Master's degree","462","358","104","2","1","1","25","21","4","18","16","2","23","17","6","0","0","0","265","205","60","7","5","2","8","7","1","114","86","28","-2"
"168421","Worcester Polytechnic Institute","2019","First major","'14'","Engineering","Doctor's degree - research/scholarship","35","28","7","0","0","0","0","0","0","1","1","0","0","0","0","0","0","0","15","11","4","0","0","0","0","0","0","19","16","3","-2"
"168421","Worcester Polytechnic Institute","2019","Second major","'14'","Engineering","Bachelor's degree","49","37","12","1","1","0","1","0","1","1","1","0","1","1","0","0","0","0","27","20","7","2","1","1","1","1","0","15","12","3","-2"
"168607","Alpena Community College","2019","First major","'14'","Engineering","Associate's degree","4","4","0","0","0","0","0","0","0","0","0","0","0","0","0","0","0","0","4","4","0","0","0","0","0","0","0","0","0","0","-2"
"168740","Andrews University","2019","First major","'14'","Engineering","Bachelor's degree","16","15","1","0","0","0","2","2","0","5","5","0","3","3","0","0","0","0","4","4","0","0","0","0","0","0","0","2","1","1","-2"
"168847","Baker College","2019","First major","'14'","Engineering","Bachelor's degree","21","17","4","0","0","0","1","1","0","0","0","0","2","1","1","0","0","0","17","14","3","1","1","0","0","0","0","0","0","0","-2"
"168883","Bay de Noc Community College","2019","First major","'14'","Engineering","Associate's degree","10","8","2","0","0","0","0","0","0","0","0","0","0","0","0","0","0","0","8","6","2","2","2","0","0","0","0","0","0","0","-2"
"169080","Calvin University","2019","First major","'14'","Engineering","Bachelor's degree","114","89","25","0","0","0","4","1","3","1","1","0","1","1","0","0","0","0","84","73","11","7","5","2","2","1","1","15","7","8","-2"
"169248","Central Michigan University","2019","First major","'14'","Engineering","Bachelor's degree","100","83","17","0","0","0","1","1","0","4","3","1","6","6","0","0","0","0","73","60","13","2","1","1","1","1","0","13","11","2","-2"
"169248","Central Michigan University","2019","First major","'14'","Engineering","Master's degree","8","6","2","0","0","0","0","0","0","0","0","0","0","0","0","0","0","0","1","0","1","0","0","0","0","0","0","7","6","1","-2"
"169521","Delta College","2019","First major","'14'","Engineering","Associate's degree","3","3","0","0","0","0","0","0","0","0","0","0","0","0","0","0","0","0","3","3","0","0","0","0","0","0","0","0","0","0","-2"
"169716","University of Detroit Mercy","2019","First major","'14'","Engineering","Bachelor's degree","80","65","15","0","0","0","4","2","2","0","0","0","3","0","3","0","0","0","22","17","5","1","0","1","1","1","0","49","45","4","-2"
"169716","University of Detroit Mercy","2019","First major","'14'","Engineering","Master's degree","41","34","7","0","0","0","1","1","0","1","1","0","0","0","0","0","0","0","20","17","3","0","0","0","3","2","1","16","13","3","-2"
"169716","University of Detroit Mercy","2019","First major","'14'","Engineering","Doctor's degree - research/scholarship","2","1","1","0","0","0","0","0","0","0","0","0","0","0","0","0","0","0","0","0","0","0","0","0","0","0","0","2","1","1","-2"
"169798","Eastern Michigan University","2019","First major","'14'","Engineering","Bachelor's degree","18","15","3","0","0","0","0","0","0","4","3","1","2","1","1","0","0","0","10","9","1","1","1","0","0","0","0","1","1","0","-2"
"169910","Ferris State University","2019","First major","'14'","Engineering","Associate's degree","0","0","0","0","0","0","0","0","0","0","0","0","0","0","0","0","0","0","0","0","0","0","0","0","0","0","0","0","0","0","-2"
"169910","Ferris State University","2019","First major","'14'","Engineering","Bachelor's degree","52","48","4","0","0","0","0","0","0","0","0","0","2","2","0","0","0","0","45","41","4","1","1","0","0","0","0","4","4","0","-2"
"169983","Kettering University","2019","First major","'14'","Engineering","Bachelor's degree","307","247","60","1","1","0","9","7","2","8","3","5","9","7","2","0","0","0","239","199","40","10","9","1","20","15","5","11","6","5","-2"
"169983","Kettering University","2019","First major","'14'","Engineering","Master's degree","32","29","3","0","0","0","0","0","0","0","0","0","0","0","0","0","0","0","6","5","1","0","0","0","1","1","0","25","23","2","-2"
"169983","Kettering University","2019","Second major","'14'","Engineering","Bachelor's degree","9","7","2","0","0","0","1","1","0","0","0","0","0","0","0","0","0","0","6","5","1","0","0","0","1","0","1","1","1","0","-2"
"169992","Gogebic Community College","2019","First major","'14'","Engineering","Associate's degree","0","0","0","0","0","0","0","0","0","0","0","0","0","0","0","0","0","0","0","0","0","0","0","0","0","0","0","0","0","0","-2"
"170082","Grand Valley State University","2019","First major","'14'","Engineering","Bachelor's degree","139","123","16","0","0","0","4","4","0","1","1","0","4","3","1","0","0","0","124","110","14","2","2","0","1","1","0","3","2","1","-2"
"170082","Grand Valley State University","2019","First major","'14'","Engineering","Master's degree","33","26","7","0","0","0","0","0","0","0","0","0","0","0","0","0","0","0","16","14","2","0","0","0","0","0","0","17","12","5","-2"
"170082","Grand Valley State University","2019","Second major","'14'","Engineering","Bachelor's degree","2","2","0","0","0","0","0","0","0","0","0","0","0","0","0","0","0","0","2","2","0","0","0","0","0","0","0","0","0","0","-2"
"170240","Henry Ford College","2019","First major","'14'","Engineering","Associate's degree","47","36","11","0","0","0","4","4","0","3","1","2","1","1","0","0","0","0","26","21","5","3","1","2","7","5","2","3","3","0","-2"
"170301","Hope College","2019","First major","'14'","Engineering","Bachelor's degree","42","29","13","0","0","0","0","0","0","0","0","0","0","0","0","0","0","0","39","27","12","1","0","1","0","0","0","2","2","0","-2"
"170541","Kalamazoo Valley Community College","2019","First major","'14'","Engineering","Associate's degree","29","27","2","0","0","0","1","1","0","0","0","0","1","1","0","0","0","0","23","21","2","1","1","0","0","0","0","3","3","0","-2"
"170620","Lake Michigan College","2019","First major","'14'","Engineering","Associate's degree","0","0","0","0","0","0","0","0","0","0","0","0","0","0","0","0","0","0","0","0","0","0","0","0","0","0","0","0","0","0","-2"
"170639","Lake Superior State University","2019","First major","'14'","Engineering","Bachelor's degree","20","19","1","2","2","0","0","0","0","0","0","0","0","0","0","0","0","0","15","14","1","0","0","0","0","0","0","3","3","0","-2"
"170657","Lansing Community College","2019","First major","'14'","Engineering","Associate's degree","14","11","3","0","0","0","2","2","0","0","0","0","2","2","0","0","0","0","9","7","2","0","0","0","0","0","0","1","0","1","-2"
"170675","Lawrence Technological University","2019","First major","'14'","Engineering","Bachelor's degree","141","118","23","1","0","1","2","2","0","5","3","2","5","2","3","0","0","0","93","78","15","2","2","0","2","2","0","31","29","2","-2"
"170675","Lawrence Technological University","2019","First major","'14'","Engineering","Master's degree","109","94","15","0","0","0","1","1","0","0","0","0","1","1","0","0","0","0","27","20","7","0","0","0","2","2","0","78","70","8","-2"
"170675","Lawrence Technological University","2019","First major","'14'","Engineering","Doctor's degree - research/scholarship","7","6","1","0","0","0","1","1","0","0","0","0","0","0","0","0","0","0","2","1","1","0","0","0","1","1","0","3","3","0","-2"
"170790","Macomb Community College","2019","First major","'14'","Engineering","Associate's degree","4","1","3","0","0","0","0","0","0","0","0","0","0","0","0","0","0","0","2","1","1","0","0","0","1","0","1","1","0","1","-2"
"170806","Madonna University","2019","First major","'14'","Engineering","Bachelor's degree","0","0","0","0","0","0","0","0","0","0","0","0","0","0","0","0","0","0","0","0","0","0","0","0","0","0","0","0","0","0","-2"
"170976","University of Michigan-Ann Arbor","2019","First major","'14'","Engineering","Bachelor's degree","1136","814","322","1","1","0","183","129","54","35","29","6","47","36","11","0","0","0","660","474","186","35","27","8","62","42","20","113","76","37","-2"
"170976","University of Michigan-Ann Arbor","2019","First major","'14'","Engineering","Master's degree","1224","891","333","1","1","0","87","60","27","18","11","7","41","33","8","1","1","0","361","255","106","24","14","10","45","38","7","646","478","168","-2"
"170976","University of Michigan-Ann Arbor","2019","First major","'14'","Engineering","Doctor's degree - research/scholarship","255","208","47","1","0","1","11","10","1","6","2","4","9","6","3","0","0","0","79","60","19","2","2","0","11","10","1","136","118","18","-2"
"171100","Michigan State University","2019","First major","'14'","Engineering","Bachelor's degree","838","634","204","0","0","0","52","39","13","19","8","11","27","18","9","1","1","0","586","444","142","19","12","7","9","7","2","125","105","20","-2"
"171100","Michigan State University","2019","First major","'14'","Engineering","Master's degree","61","47","14","0","0","0","6","4","2","0","0","0","1","1","0","0","0","0","18","14","4","0","0","0","0","0","0","36","28","8","-2"
"171100","Michigan State University","2019","First major","'14'","Engineering","Doctor's degree - research/scholarship","64","49","15","0","0","0","0","0","0","0","0","0","1","0","1","0","0","0","13","10","3","1","1","0","1","0","1","48","38","10","-2"
"171128","Michigan Technological University","2019","First major","'14'","Engineering","Bachelor's degree","757","564","193","3","2","1","14","8","6","7","4","3","16","14","2","0","0","0","670","503","167","20","12","8","10","7","3","17","14","3","-2"
"171128","Michigan Technological University","2019","First major","'14'","Engineering","Master's degree","260","209","51","0","0","0","2","2","0","2","1","1","2","1","1","0","0","0","58","40","18","1","0","1","6","4","2","189","161","28","-2"
"171128","Michigan Technological University","2019","First major","'14'","Engineering","Doctor's degree - research/scholarship","45","33","12","0","0","0","0","0","0","1","1","0","1","1","0","0","0","0","6","4","2","0","0","0","2","1","1","35","26","9","-2"
"171128","Michigan Technological University","2019","Second major","'14'","Engineering","Bachelor's degree","15","14","1","0","0","0","1","0","1","0","0","0","0","0","0","0","0","0","14","14","0","0","0","0","0","0","0","0","0","0","-2"
"171137","University of Michigan-Dearborn","2019","First major","'14'","Engineering","Bachelor's degree","287","220","67","1","1","0","18","16","2","9","6","3","16","11","5","0","0","0","220","169","51","7","7","0","11","6","5","5","4","1","-2"
"171137","University of Michigan-Dearborn","2019","First major","'14'","Engineering","Master's degree","249","192","57","0","0","0","17","13","4","7","1","6","6","5","1","0","0","0","86","75","11","2","2","0","6","6","0","125","90","35","-2"
"171137","University of Michigan-Dearborn","2019","First major","'14'","Engineering","Doctor's degree - research/scholarship","1","1","0","0","0","0","0","0","0","0","0","0","0","0","0","0","0","0","0","0","0","0","0","0","0","0","0","1","1","0","-2"
"171146","University of Michigan-Flint","2019","First major","'14'","Engineering","Bachelor's degree","30","25","5","0","0","0","1","1","0","1","1","0","1","1","0","0","0","0","20","15","5","3","3","0","0","0","0","4","4","0","-2"
"171304","Muskegon Community College","2019","First major","'14'","Engineering","Associate's degree","1","1","0","0","0","0","0","0","0","0","0","0","0","0","0","0","0","0","1","1","0","0","0","0","0","0","0","0","0","0","-2"
"171483","Northwestern Michigan College","2019","First major","'14'","Engineering","Bachelor's degree","4","4","0","0","0","0","0","0","0","0","0","0","0","0","0","0","0","0","4","4","0","0","0","0","0","0","0","0","0","0","-2"
"171571","Oakland University","2019","First major","'14'","Engineering","Bachelor's degree","314","274","40","1","1","0","15","14","1","5","4","1","3","2","1","0","0","0","231","202","29","4","3","1","15","11","4","40","37","3","-2"
"171571","Oakland University","2019","First major","'14'","Engineering","Master's degree","138","95","43","1","1","0","9","6","3","6","5","1","5","5","0","0","0","0","50","39","11","3","1","2","7","6","1","57","32","25","-2"
"171571","Oakland University","2019","First major","'14'","Engineering","Doctor's degree - research/scholarship","19","17","2","0","0","0","3","3","0","0","0","0","0","0","0","0","0","0","7","7","0","0","0","0","3","2","1","6","5","1","-2"
"171571","Oakland University","2019","Second major","'14'","Engineering","Bachelor's degree","24","22","2","0","0","0","2","2","0","0","0","0","0","0","0","0","0","0","20","19","1","0","0","0","1","1","0","1","0","1","-2"
"172051","Saginaw Valley State University","2019","First major","'14'","Engineering","Bachelor's degree","72","66","6","0","0","0","1","1","0","1","1","0","1","1","0","0","0","0","58","52","6","0","0","0","3","3","0","8","8","0","-2"
"172200","Schoolcraft College","2019","First major","'14'","Engineering","Associate's degree","50","41","9","0","0","0","4","4","0","1","1","0","0","0","0","0","0","0","36","30","6","2","0","2","3","3","0","4","3","1","-2"
"172264","Siena Heights University","2019","First major","'14'","Engineering","Associate's degree","0","0","0","0","0","0","0","0","0","0","0","0","0","0","0","0","0","0","0","0","0","0","0","0","0","0","0","0","0","0","-2"
"172334","Spring Arbor University","2019","First major","'14'","Engineering","Bachelor's degree","3","3","0","0","0","0","0","0","0","0","0","0","0","0","0","0","0","0","3","3","0","0","0","0","0","0","0","0","0","0","-2"
"172617","Washtenaw Community College","2019","First major","'14'","Engineering","Associate's degree","4","2","2","0","0","0","1","1","0","0","0","0","0","0","0","0","0","0","1","1","0","1","0","1","0","0","0","1","0","1","-2"
"172635","Wayne County Community College District","2019","First major","'14'","Engineering","Associate's degree","10","8","2","0","0","0","0","0","0","8","6","2","1","1","0","0","0","0","0","0","0","0","0","0","0","0","0","1","1","0","-2"
"172644","Wayne State University","2019","First major","'14'","Engineering","Bachelor's degree","279","215","64","0","0","0","25","17","8","17","13","4","13","11","2","0","0","0","190","148","42","6","6","0","9","7","2","19","13","6","-2"
"172644","Wayne State University","2019","First major","'14'","Engineering","Master's degree","339","287","52","0","0","0","46","42","4","8","6","2","4","1","3","0","0","0","68","49","19","2","1","1","2","2","0","209","186","23","-2"
"172644","Wayne State University","2019","First major","'14'","Engineering","Doctor's degree - research/scholarship","32","26","6","0","0","0","0","0","0","1","1","0","0","0","0","0","0","0","15","10","5","1","1","0","1","1","0","14","13","1","-2"
"172644","Wayne State University","2019","Second major","'14'","Engineering","Doctor's degree - research/scholarship","1","1","0","0","0","0","0","0","0","0","0","0","0","0","0","0","0","0","1","1","0","0","0","0","0","0","0","0","0","0","-2"
"172699","Western Michigan University","2019","First major","'14'","Engineering","Bachelor's degree","296","251","45","2","2","0","8","7","1","13","8","5","20","15","5","0","0","0","199","171","28","7","5","2","7","7","0","40","36","4","-2"
"172699","Western Michigan University","2019","First major","'14'","Engineering","Master's degree","150","128","22","0","0","0","1","0","1","2","2","0","1","1","0","0","0","0","13","9","4","1","1","0","0","0","0","132","115","17","-2"
"172699","Western Michigan University","2019","First major","'14'","Engineering","Doctor's degree - research/scholarship","21","19","2","0","0","0","0","0","0","0","0","0","0","0","0","0","0","0","2","2","0","0","0","0","1","1","0","18","16","2","-2"
"172699","Western Michigan University","2019","Second major","'14'","Engineering","Bachelor's degree","1","1","0","0","0","0","0","0","0","0","0","0","0","0","0","0","0","0","1","1","0","0","0","0","0","0","0","0","0","0","-2"
"172963","Anoka-Ramsey Community College","2019","First major","'14'","Engineering","Associate's degree","9","8","1","0","0","0","1","1","0","0","0","0","1","1","0","0","0","0","7","6","1","0","0","0","0","0","0","0","0","0","-2"
"173142","Bethany Lutheran College","2019","First major","'14'","Engineering","Bachelor's degree","3","3","0","0","0","0","0","0","0","0","0","0","0","0","0","0","0","0","2","2","0","0","0","0","0","0","0","1","1","0","-2"
"173160","Bethel University","2019","First major","'14'","Engineering","Bachelor's degree","3","3","0","0","0","0","0","0","0","0","0","0","0","0","0","0","0","0","3","3","0","0","0","0","0","0","0","0","0","0","-2"
"173160","Bethel University","2019","Second major","'14'","Engineering","Bachelor's degree","2","1","1","0","0","0","0","0","0","0","0","0","0","0","0","0","0","0","2","1","1","0","0","0","0","0","0","0","0","0","-2"
"173203","Central Lakes College-Brainerd","2019","First major","'14'","Engineering","Associate's degree","0","0","0","0","0","0","0","0","0","0","0","0","0","0","0","0","0","0","0","0","0","0","0","0","0","0","0","0","0","0","-2"
"173559","Minnesota State Community and Technical College","2019","First major","'14'","Engineering","Associate's degree","9","8","1","0","0","0","1","1","0","3","2","1","0","0","0","0","0","0","4","4","0","0","0","0","0","0","0","1","1","0","-2"
"173665","Hamline University","2019","First major","'14'","Engineering","Bachelor's degree","1","1","0","0","0","0","0","0","0","0","0","0","0","0","0","0","0","0","1","1","0","0","0","0","0","0","0","0","0","0","-2"
"173735","Hibbing Community College","2019","First major","'14'","Engineering","Associate's degree","0","0","0","0","0","0","0","0","0","0","0","0","0","0","0","0","0","0","0","0","0","0","0","0","0","0","0","0","0","0","-2"
"173799","Inver Hills Community College","2019","First major","'14'","Engineering","Associate's degree","5","3","2","0","0","0","0","0","0","0","0","0","2","1","1","0","0","0","2","2","0","0","0","0","0","0","0","1","0","1","-2"
"173805","Itasca Community College","2019","First major","'14'","Engineering","Associate's degree","42","37","5","0","0","0","0","0","0","0","0","0","1","1","0","0","0","0","36","31","5","3","3","0","0","0","0","2","2","0","-2"
"173911","South Central College","2019","First major","'14'","Engineering","Associate's degree","0","0","0","0","0","0","0","0","0","0","0","0","0","0","0","0","0","0","0","0","0","0","0","0","0","0","0","0","0","0","-2"
"173920","Minnesota State University-Mankato","2019","First major","'14'","Engineering","Bachelor's degree","108","90","18","0","0","0","0","0","0","2","2","0","2","2","0","0","0","0","81","68","13","3","3","0","0","0","0","20","15","5","-2"
"173920","Minnesota State University-Mankato","2019","First major","'14'","Engineering","Master's degree","7","6","1","0","0","0","0","0","0","0","0","0","0","0","0","0","0","0","0","0","0","0","0","0","0","0","0","7","6","1","-2"
"173957","Mayo Clinic College of Medicine and Science","2019","First major","'14'","Engineering","Master's degree","0","0","0","0","0","0","0","0","0","0","0","0","0","0","0","0","0","0","0","0","0","0","0","0","0","0","0","0","0","0","-2"
"173957","Mayo Clinic College of Medicine and Science","2019","First major","'14'","Engineering","Doctor's degree - research/scholarship","2","1","1","0","0","0","0","0","0","0","0","0","0","0","0","0","0","0","2","1","1","0","0","0","0","0","0","0","0","0","-2"
"174066","University of Minnesota-Twin Cities","2019","First major","'14'","Engineering","Bachelor's degree","879","637","242","0","0","0","96","66","30","19","13","6","21","12","9","0","0","0","610","444","166","28","20","8","4","3","1","101","79","22","-2"
"174066","University of Minnesota-Twin Cities","2019","First major","'14'","Engineering","Master's degree","346","257","89","0","0","0","11","10","1","9","7","2","6","4","2","0","0","0","157","116","41","8","5","3","5","4","1","150","111","39","-2"
"174066","University of Minnesota-Twin Cities","2019","First major","'14'","Engineering","Doctor's degree - research/scholarship","141","116","25","0","0","0","8","7","1","0","0","0","2","2","0","0","0","0","40","32","8","0","0","0","1","1","0","90","74","16","-2"
"174066","University of Minnesota-Twin Cities","2019","Second major","'14'","Engineering","Bachelor's degree","49","32","17","0","0","0","7","5","2","0","0","0","1","0","1","0","0","0","37","24","13","1","1","0","0","0","0","3","2","1","-2"
"174075","University of Minnesota-Crookston","2019","First major","'14'","Engineering","Bachelor's degree","10","8","2","0","0","0","0","0","0","0","0","0","0","0","0","0","0","0","6","5","1","0","0","0","0","0","0","4","3","1","-2"
"174233","University of Minnesota-Duluth","2019","First major","'14'","Engineering","Bachelor's degree","305","268","37","0","0","0","7","7","0","6","3","3","5","5","0","0","0","0","277","245","32","2","0","2","1","1","0","7","7","0","-2"
"174233","University of Minnesota-Duluth","2019","First major","'14'","Engineering","Master's degree","20","15","5","0","0","0","0","0","0","1","1","0","1","0","1","0","0","0","14","11","3","0","0","0","0","0","0","4","3","1","-2"
"174376","North Hennepin Community College","2019","First major","'14'","Engineering","Associate's degree","4","4","0","0","0","0","0","0","0","1","1","0","1","1","0","0","0","0","2","2","0","0","0","0","0","0","0","0","0","0","-2"
"174428","Normandale Community College","2019","First major","'14'","Engineering","Associate's degree","27","27","0","0","0","0","4","4","0","2","2","0","4","4","0","0","0","0","13","13","0","1","1","0","2","2","0","1","1","0","-2"
"174491","University of Northwestern-St Paul","2019","First major","'14'","Engineering","Bachelor's degree","0","0","0","0","0","0","0","0","0","0","0","0","0","0","0","0","0","0","0","0","0","0","0","0","0","0","0","0","0","0","-2"
"174738","Rochester Community and Technical College","2019","First major","'14'","Engineering","Associate's degree","5","5","0","0","0","0","1","1","0","0","0","0","0","0","0","0","0","0","3","3","0","0","0","0","0","0","0","1","1","0","-2"
"174783","Saint Cloud State University","2019","First major","'14'","Engineering","Bachelor's degree","91","84","7","0","0","0","8","8","0","4","4","0","5","5","0","0","0","0","63","56","7","1","1","0","1","1","0","9","9","0","-2"
"174783","Saint Cloud State University","2019","First major","'14'","Engineering","Master's degree","22","11","11","0","0","0","1","1","0","0","0","0","1","1","0","0","0","0","9","4","5","0","0","0","5","3","2","6","2","4","-2"
"174783","Saint Cloud State University","2019","Second major","'14'","Engineering","Bachelor's degree","9","9","0","0","0","0","1","1","0","0","0","0","0","0","0","0","0","0","5","5","0","0","0","0","0","0","0","3","3","0","-2"
"174817","Saint Mary's University of Minnesota","2019","First major","'14'","Engineering","Bachelor's degree","1","1","0","0","0","0","0","0","0","0","0","0","0","0","0","0","0","0","0","0","0","0","0","0","0","0","0","1","1","0","-2"
"174914","University of St Thomas","2019","First major","'14'","Engineering","Bachelor's degree","143","114","29","0","0","0","6","4","2","6","6","0","5","3","2","0","0","0","111","87","24","4","3","1","4","4","0","7","7","0","-2"
"174914","University of St Thomas","2019","First major","'14'","Engineering","Master's degree","66","54","12","0","0","0","7","4","3","8","6","2","1","1","0","0","0","0","28","24","4","5","4","1","2","2","0","15","13","2","-2"
"174914","University of St Thomas","2019","Second major","'14'","Engineering","Bachelor's degree","1","1","0","0","0","0","0","0","0","0","0","0","0","0","0","0","0","0","0","0","0","0","0","0","1","1","0","0","0","0","-2"
"175014","Rasmussen University-Minnesota","2019","First major","'14'","Engineering","Associate's degree","11","6","5","0","0","0","1","0","1","2","1","1","0","0","0","0","0","0","5","4","1","0","0","0","3","1","2","0","0","0","-2"
"175041","Saint Paul College","2019","First major","'14'","Engineering","Associate's degree","1","0","1","0","0","0","0","0","0","0","0","0","1","0","1","0","0","0","0","0","0","0","0","0","0","0","0","0","0","0","-2"
"175227","Dunwoody College of Technology","2019","First major","'14'","Engineering","Bachelor's degree","19","17","2","0","0","0","2","1","1","2","2","0","0","0","0","0","0","0","14","13","1","0","0","0","1","1","0","0","0","0","-2"
"175272","Winona State University","2019","First major","'14'","Engineering","Bachelor's degree","28","23","5","0","0","0","1","0","1","0","0","0","0","0","0","0","0","0","24","20","4","0","0","0","2","2","0","1","1","0","-2"
"175315","Century College","2019","First major","'14'","Engineering","Associate's degree","29","25","4","0","0","0","4","4","0","2","1","1","1","0","1","0","0","0","18","17","1","2","2","0","0","0","0","2","1","1","-2"
"175573","Copiah-Lincoln Community College","2019","First major","'14'","Engineering","Associate's degree","22","21","1","0","0","0","0","0","0","3","3","0","1","1","0","0","0","0","16","15","1","0","0","0","2","2","0","0","0","0","-2"
"175652","East Mississippi Community College","2019","First major","'14'","Engineering","Associate's degree","24","23","1","0","0","0","0","0","0","6","6","0","0","0","0","0","0","0","18","17","1","0","0","0","0","0","0","0","0","0","-2"
"175810","Holmes Community College","2019","First major","'14'","Engineering","Associate's degree","40","32","8","0","0","0","0","0","0","9","5","4","1","1","0","0","0","0","30","26","4","0","0","0","0","0","0","0","0","0","-2"
"175829","Itawamba Community College","2019","First major","'14'","Engineering","Associate's degree","26","24","2","0","0","0","0","0","0","7","6","1","2","2","0","0","0","0","17","16","1","0","0","0","0","0","0","0","0","0","-2"
"175856","Jackson State University","2019","First major","'14'","Engineering","Bachelor's degree","80","57","23","0","0","0","2","1","1","63","45","18","1","1","0","0","0","0","5","4","1","1","1","0","0","0","0","8","5","3","-2"
"175856","Jackson State University","2019","First major","'14'","Engineering","Master's degree","13","12","1","0","0","0","1","1","0","7","6","1","0","0","0","0","0","0","0","0","0","0","0","0","0","0","0","5","5","0","-2"
"175856","Jackson State University","2019","First major","'14'","Engineering","Doctor's degree - research/scholarship","4","2","2","0","0","0","0","0","0","0","0","0","0","0","0","0","0","0","0","0","0","0","0","0","0","0","0","4","2","2","-2"
"176008","Mississippi Delta Community College","2019","First major","'14'","Engineering","Associate's degree","2","2","0","0","0","0","0","0","0","1","1","0","1","1","0","0","0","0","0","0","0","0","0","0","0","0","0","0","0","0","-2"
"176017","University of Mississippi","2019","First major","'14'","Engineering","Bachelor's degree","211","153","58","0","0","0","6","4","2","12","6","6","6","5","1","2","2","0","160","115","45","3","2","1","0","0","0","22","19","3","-2"
"176017","University of Mississippi","2019","First major","'14'","Engineering","Master's degree","37","27","10","0","0","0","1","1","0","2","1","1","0","0","0","0","0","0","18","14","4","1","0","1","0","0","0","15","11","4","-2"
"176017","University of Mississippi","2019","First major","'14'","Engineering","Doctor's degree - research/scholarship","18","14","4","0","0","0","0","0","0","1","1","0","0","0","0","0","0","0","5","5","0","0","0","0","0","0","0","12","8","4","-2"
"176053","Mississippi College","2019","First major","'14'","Engineering","Bachelor's degree","3","2","1","0","0","0","1","1","0","0","0","0","0","0","0","0","0","0","2","1","1","0","0","0","0","0","0","0","0","0","-2"
"176053","Mississippi College","2019","First major","'14'","Engineering","Master's degree","4","3","1","0","0","0","1","1","0","1","0","1","0","0","0","0","0","0","1","1","0","0","0","0","0","0","0","1","1","0","-2"
"176071","Mississippi Gulf Coast Community College","2019","First major","'14'","Engineering","Associate's degree","73","57","16","0","0","0","6","2","4","13","9","4","7","5","2","0","0","0","46","40","6","1","1","0","0","0","0","0","0","0","-2"
"176080","Mississippi State University","2019","First major","'14'","Engineering","Bachelor's degree","655","508","147","5","5","0","20","16","4","59","43","16","5","4","1","1","1","0","532","414","118","11","6","5","2","2","0","20","17","3","-2"
"176080","Mississippi State University","2019","First major","'14'","Engineering","Master's degree","109","73","36","0","0","0","3","2","1","6","4","2","4","2","2","1","1","0","60","41","19","1","1","0","1","1","0","33","21","12","-2"
"176080","Mississippi State University","2019","First major","'14'","Engineering","Doctor's degree - research/scholarship","42","33","9","0","0","0","2","0","2","0","0","0","0","0","0","1","1","0","13","9","4","0","0","0","0","0","0","26","23","3","-2"
"176169","Northeast Mississippi Community College","2019","First major","'14'","Engineering","Associate's degree","5","5","0","0","0","0","0","0","0","0","0","0","0","0","0","0","0","0","5","5","0","0","0","0","0","0","0","0","0","0","-2"
"176239","Pearl River Community College","2019","First major","'14'","Engineering","Associate's degree","0","0","0","0","0","0","0","0","0","0","0","0","0","0","0","0","0","0","0","0","0","0","0","0","0","0","0","0","0","0","-2"
"176372","University of Southern Mississippi","2019","First major","'14'","Engineering","Bachelor's degree","9","8","1","0","0","0","0","0","0","1","1","0","1","1","0","0","0","0","7","6","1","0","0","0","0","0","0","0","0","0","-2"
"176372","University of Southern Mississippi","2019","First major","'14'","Engineering","Master's degree","6","5","1","0","0","0","2","2","0","0","0","0","1","1","0","0","0","0","2","2","0","1","0","1","0","0","0","0","0","0","-2"
"176372","University of Southern Mississippi","2019","First major","'14'","Engineering","Doctor's degree - research/scholarship","14","12","2","0","0","0","4","4","0","0","0","0","2","1","1","0","0","0","7","7","0","1","0","1","0","0","0","0","0","0","-2"
"176965","University of Central Missouri","2019","First major","'14'","Engineering","Master's degree","25","21","4","0","0","0","0","0","0","2","2","0","0","0","0","0","0","0","9","9","0","0","0","0","1","0","1","13","10","3","-2"
"177065","Columbia College","2019","First major","'14'","Engineering","Associate's degree","2","2","0","0","0","0","0","0","0","0","0","0","0","0","0","0","0","0","2","2","0","0","0","0","0","0","0","0","0","0","-2"
"177135","Crowder College","2019","First major","'14'","Engineering","Associate's degree","5","4","1","0","0","0","0","0","0","0","0","0","1","0","1","0","0","0","4","4","0","0","0","0","0","0","0","0","0","0","-2"
"177214","Drury University","2019","First major","'14'","Engineering","Bachelor's degree","7","5","2","0","0","0","0","0","0","0","0","0","0","0","0","0","0","0","5","4","1","0","0","0","0","0","0","2","1","1","-2"
"177250","East Central College","2019","First major","'14'","Engineering","Associate's degree","21","19","2","0","0","0","0","0","0","0","0","0","0","0","0","0","0","0","20","18","2","0","0","0","1","1","0","0","0","0","-2"
"177339","Evangel University","2019","First major","'14'","Engineering","Associate's degree","0","0","0","0","0","0","0","0","0","0","0","0","0","0","0","0","0","0","0","0","0","0","0","0","0","0","0","0","0","0","-2"
"177472","Ozarks Technical Community College","2019","First major","'14'","Engineering","Associate's degree","23","22","1","0","0","0","0","0","0","0","0","0","0","0","0","0","0","0","23","22","1","0","0","0","0","0","0","0","0","0","-2"
"177676","Jefferson College","2019","First major","'14'","Engineering","Associate's degree","9","8","1","0","0","0","0","0","0","0","0","0","0","0","0","0","0","0","8","7","1","1","1","0","0","0","0","0","0","0","-2"
"177995","Metropolitan Community College-Kansas City","2019","First major","'14'","Engineering","Associate's degree","38","29","9","0","0","0","4","3","1","1","1","0","1","0","1","0","0","0","27","22","5","4","2","2","0","0","0","1","1","0","-2"
"178396","University of Missouri-Columbia","2019","First major","'14'","Engineering","Bachelor's degree","554","445","109","0","0","0","16","12","4","24","19","5","15","12","3","0","0","0","408","328","80","13","13","0","11","9","2","67","52","15","-2"
"178396","University of Missouri-Columbia","2019","First major","'14'","Engineering","Master's degree","82","65","17","0","0","0","3","3","0","2","2","0","0","0","0","0","0","0","26","24","2","2","2","0","1","1","0","48","33","15","-2"
"178396","University of Missouri-Columbia","2019","First major","'14'","Engineering","Doctor's degree - research/scholarship","39","33","6","0","0","0","0","0","0","2","2","0","1","1","0","0","0","0","1","1","0","0","0","0","2","1","1","33","28","5","-2"
"178402","University of Missouri-Kansas City","2019","First major","'14'","Engineering","Bachelor's degree","133","112","21","0","0","0","7","5","2","14","13","1","10","9","1","0","0","0","69","60","9","2","1","1","14","11","3","17","13","4","-2"
"178402","University of Missouri-Kansas City","2019","First major","'14'","Engineering","Master's degree","102","79","23","0","0","0","5","3","2","4","4","0","7","7","0","0","0","0","26","20","6","1","1","0","4","4","0","55","40","15","-2"
"178411","Missouri University of Science and Technology","2019","First major","'14'","Engineering","Bachelor's degree","948","759","189","2","2","0","29","19","10","19","16","3","31","24","7","0","0","0","798","641","157","17","12","5","24","21","3","28","24","4","-2"
"178411","Missouri University of Science and Technology","2019","First major","'14'","Engineering","Master's degree","293","249","44","1","0","1","9","6","3","8","5","3","9","7","2","0","0","0","164","141","23","5","4","1","5","5","0","92","81","11","-2"
"178411","Missouri University of Science and Technology","2019","First major","'14'","Engineering","Doctor's degree - research/scholarship","80","68","12","0","0","0","1","1","0","1","1","0","1","1","0","0","0","0","13","10","3","1","1","0","0","0","0","63","54","9","-2"
"178420","University of Missouri-St Louis","2019","First major","'14'","Engineering","Bachelor's degree","54","46","8","0","0","0","4","4","0","2","2","0","1","0","1","0","0","0","44","37","7","1","1","0","1","1","0","1","1","0","-2"
"178448","Moberly Area Community College","2019","First major","'14'","Engineering","Associate's degree","22","19","3","0","0","0","1","0","1","0","0","0","2","1","1","0","0","0","18","17","1","0","0","0","1","1","0","0","0","0","-2"
"178721","Park University","2019","First major","'14'","Engineering","Bachelor's degree","4","3","1","0","0","0","0","0","0","1","1","0","0","0","0","0","0","0","1","1","0","1","0","1","1","1","0","0","0","0","-2"
"179043","Rockhurst University","2019","First major","'14'","Engineering","Bachelor's degree","9","9","0","1","1","0","0","0","0","0","0","0","1","1","0","0","0","0","6","6","0","0","0","0","1","1","0","0","0","0","-2"
"179159","Saint Louis University","2019","First major","'14'","Engineering","Bachelor's degree","118","81","37","0","0","0","15","8","7","1","0","1","5","4","1","0","0","0","79","56","23","1","0","1","2","2","0","15","11","4","-2"
"179159","Saint Louis University","2019","First major","'14'","Engineering","Master's degree","27","17","10","0","0","0","6","3","3","0","0","0","0","0","0","0","0","0","12","7","5","0","0","0","0","0","0","9","7","2","-2"
"179159","Saint Louis University","2019","First major","'14'","Engineering","Doctor's degree - research/scholarship","5","4","1","0","0","0","1","1","0","0","0","0","0","0","0","0","0","0","1","0","1","0","0","0","0","0","0","3","3","0","-2"
"179159","Saint Louis University","2019","Second major","'14'","Engineering","Bachelor's degree","1","1","0","0","0","0","0","0","0","0","0","0","0","0","0","0","0","0","1","1","0","0","0","0","0","0","0","0","0","0","-2"
"179344","Missouri State University-West Plains","2019","First major","'14'","Engineering","Associate's degree","5","5","0","0","0","0","0","0","0","0","0","0","0","0","0","0","0","0","5","5","0","0","0","0","0","0","0","0","0","0","-2"
"179539","State Fair Community College","2019","First major","'14'","Engineering","Associate's degree","3","3","0","0","0","0","0","0","0","0","0","0","0","0","0","0","0","0","3","3","0","0","0","0","0","0","0","0","0","0","-2"
"179557","Southeast Missouri State University","2019","First major","'14'","Engineering","Bachelor's degree","2","2","0","0","0","0","0","0","0","0","0","0","0","0","0","0","0","0","2","2","0","0","0","0","0","0","0","0","0","0","-2"
"179557","Southeast Missouri State University","2019","Second major","'14'","Engineering","Bachelor's degree","1","1","0","0","0","0","0","0","0","0","0","0","0","0","0","0","0","0","1","1","0","0","0","0","0","0","0","0","0","0","-2"
"179566","Missouri State University-Springfield","2019","First major","'14'","Engineering","Bachelor's degree","0","0","0","0","0","0","0","0","0","0","0","0","0","0","0","0","0","0","0","0","0","0","0","0","0","0","0","0","0","0","-2"
"179645","Three Rivers College","2019","First major","'14'","Engineering","Associate's degree","0","0","0","0","0","0","0","0","0","0","0","0","0","0","0","0","0","0","0","0","0","0","0","0","0","0","0","0","0","0","-2"
"179867","Washington University in St Louis","2019","First major","'14'","Engineering","Bachelor's degree","251","166","85","0","0","0","36","23","13","10","8","2","16","13","3","0","0","0","144","98","46","14","8","6","3","2","1","28","14","14","-2"
"179867","Washington University in St Louis","2019","First major","'14'","Engineering","Master's degree","277","213","64","0","0","0","10","9","1","9","6","3","7","7","0","0","0","0","97","73","24","3","2","1","11","9","2","140","107","33","-2"
"179867","Washington University in St Louis","2019","First major","'14'","Engineering","Doctor's degree - research/scholarship","57","38","19","0","0","0","2","1","1","0","0","0","1","0","1","0","0","0","13","10","3","1","1","0","4","3","1","36","23","13","-2"
"179867","Washington University in St Louis","2019","Second major","'14'","Engineering","Bachelor's degree","8","6","2","0","0","0","1","1","0","0","0","0","1","1","0","0","0","0","3","2","1","1","0","1","0","0","0","2","2","0","-2"
"179964","William Woods University","2019","First major","'14'","Engineering","Associate's degree","0","0","0","0","0","0","0","0","0","0","0","0","0","0","0","0","0","0","0","0","0","0","0","0","0","0","0","0","0","0","-2"
"180054","Blackfeet Community College","2019","First major","'14'","Engineering","Associate's degree","1","0","1","1","0","1","0","0","0","0","0","0","0","0","0","0","0","0","0","0","0","0","0","0","0","0","0","0","0","0","-2"
"180106","Carroll College","2019","First major","'14'","Engineering","Bachelor's degree","16","14","2","0","0","0","0","0","0","0","0","0","3","3","0","0","0","0","13","11","2","0","0","0","0","0","0","0","0","0","-2"
"180212","Fort Peck Community College","2019","First major","'14'","Engineering","Associate's degree","0","0","0","0","0","0","0","0","0","0","0","0","0","0","0","0","0","0","0","0","0","0","0","0","0","0","0","0","0","0","-2"
"180328","Little Big Horn College","2019","First major","'14'","Engineering","Associate's degree","0","0","0","0","0","0","0","0","0","0","0","0","0","0","0","0","0","0","0","0","0","0","0","0","0","0","0","0","0","0","-2"
"180416","Montana Technological University","2019","First major","'14'","Engineering","Bachelor's degree","285","242","43","2","2","0","3","3","0","1","1","0","6","3","3","0","0","0","178","146","32","0","0","0","17","11","6","78","76","2","-2"
"180416","Montana Technological University","2019","First major","'14'","Engineering","Master's degree","26","15","11","0","0","0","0","0","0","0","0","0","0","0","0","0","0","0","20","11","9","0","0","0","1","1","0","5","3","2","-2"
"180461","Montana State University","2019","First major","'14'","Engineering","Bachelor's degree","501","387","114","2","2","0","4","1","3","1","0","1","18","14","4","1","1","0","368","280","88","24","23","1","16","15","1","67","51","16","-2"
"180461","Montana State University","2019","First major","'14'","Engineering","Master's degree","40","29","11","0","0","0","0","0","0","1","1","0","3","2","1","0","0","0","26","20","6","1","1","0","0","0","0","9","5","4","-2"
"180461","Montana State University","2019","First major","'14'","Engineering","Doctor's degree - research/scholarship","13","11","2","0","0","0","0","0","0","0","0","0","0","0","0","0","0","0","7","6","1","0","0","0","0","0","0","6","5","1","-2"
"180647","Salish Kootenai College","2019","First major","'14'","Engineering","Associate's degree","0","0","0","0","0","0","0","0","0","0","0","0","0","0","0","0","0","0","0","0","0","0","0","0","0","0","0","0","0","0","-2"
"181020","Doane University","2019","First major","'14'","Engineering","Bachelor's degree","5","5","0","0","0","0","0","0","0","0","0","0","1","1","0","0","0","0","4","4","0","0","0","0","0","0","0","0","0","0","-2"
"181303","Metropolitan Community College Area","2019","First major","'14'","Engineering","Associate's degree","6","5","1","0","0","0","1","1","0","1","1","0","0","0","0","0","0","0","2","1","1","0","0","0","1","1","0","1","1","0","-2"
"181464","University of Nebraska-Lincoln","2019","First major","'14'","Engineering","Bachelor's degree","509","406","103","0","0","0","23","15","8","10","8","2","15","14","1","0","0","0","376","300","76","5","3","2","12","9","3","68","57","11","-2"
"181464","University of Nebraska-Lincoln","2019","First major","'14'","Engineering","Master's degree","106","82","24","0","0","0","5","4","1","2","2","0","5","3","2","0","0","0","56","48","8","4","3","1","1","1","0","33","21","12","-2"
"181464","University of Nebraska-Lincoln","2019","First major","'14'","Engineering","Doctor's degree - research/scholarship","51","41","10","0","0","0","0","0","0","0","0","0","0","0","0","0","0","0","9","8","1","0","0","0","0","0","0","42","33","9","-2"
"181491","Northeast Community College","2019","First major","'14'","Engineering","Associate's degree","3","3","0","0","0","0","0","0","0","1","1","0","0","0","0","0","0","0","1","1","0","0","0","0","0","0","0","1","1","0","-2"
"181738","Union College","2019","First major","'14'","Engineering","Associate's degree","2","2","0","0","0","0","0","0","0","0","0","0","0","0","0","0","0","0","2","2","0","0","0","0","0","0","0","0","0","0","-2"
"181738","Union College","2019","First major","'14'","Engineering","Bachelor's degree","0","0","0","0","0","0","0","0","0","0","0","0","0","0","0","0","0","0","0","0","0","0","0","0","0","0","0","0","0","0","-2"
"181817","Western Nebraska Community College","2019","First major","'14'","Engineering","Associate's degree","0","0","0","0","0","0","0","0","0","0","0","0","0","0","0","0","0","0","0","0","0","0","0","0","0","0","0","0","0","0","-2"
"182005","College of Southern Nevada","2019","First major","'14'","Engineering","Associate's degree","8","7","1","0","0","0","1","1","0","0","0","0","4","4","0","0","0","0","3","2","1","0","0","0","0","0","0","0","0","0","-2"
"182281","University of Nevada-Las Vegas","2019","First major","'14'","Engineering","Bachelor's degree","137","111","26","0","0","0","24","20","4","2","2","0","31","24","7","0","0","0","53","45","8","22","17","5","2","2","0","3","1","2","-2"
"182281","University of Nevada-Las Vegas","2019","First major","'14'","Engineering","Master's degree","44","32","12","0","0","0","7","6","1","0","0","0","5","3","2","0","0","0","18","12","6","2","2","0","2","2","0","10","7","3","-2"
"182281","University of Nevada-Las Vegas","2019","First major","'14'","Engineering","Doctor's degree - research/scholarship","10","5","5","0","0","0","0","0","0","0","0","0","0","0","0","0","0","0","2","0","2","0","0","0","1","0","1","7","5","2","-2"
"182290","University of Nevada-Reno","2019","First major","'14'","Engineering","Bachelor's degree","495","410","85","2","2","0","43","37","6","8","4","4","89","72","17","3","2","1","291","243","48","37","32","5","9","8","1","13","10","3","-2"
"182290","University of Nevada-Reno","2019","First major","'14'","Engineering","Master's degree","64","51","13","0","0","0","5","5","0","0","0","0","4","1","3","0","0","0","26","20","6","0","0","0","2","2","0","27","23","4","-2"
"182290","University of Nevada-Reno","2019","First major","'14'","Engineering","Doctor's degree - research/scholarship","29","24","5","0","0","0","3","2","1","0","0","0","1","1","0","0","0","0","4","3","1","0","0","0","0","0","0","21","18","3","-2"
"182500","Truckee Meadows Community College","2019","First major","'14'","Engineering","Associate's degree","0","0","0","0","0","0","0","0","0","0","0","0","0","0","0","0","0","0","0","0","0","0","0","0","0","0","0","0","0","0","-2"
"182564","Western Nevada College","2019","First major","'14'","Engineering","Associate's degree","0","0","0","0","0","0","0","0","0","0","0","0","0","0","0","0","0","0","0","0","0","0","0","0","0","0","0","0","0","0","-2"
"182670","Dartmouth College","2019","First major","'14'","Engineering","Bachelor's degree","116","72","44","0","0","0","18","7","11","6","5","1","10","5","5","1","1","0","63","42","21","5","4","1","3","1","2","10","7","3","-2"
"182670","Dartmouth College","2019","First major","'14'","Engineering","Master's degree","180","101","79","1","0","1","17","6","11","10","7","3","12","4","8","0","0","0","69","45","24","5","4","1","6","4","2","60","31","29","-2"
"182670","Dartmouth College","2019","First major","'14'","Engineering","Doctor's degree - research/scholarship","22","18","4","0","0","0","4","3","1","0","0","0","1","1","0","0","0","0","9","8","1","1","0","1","0","0","0","7","6","1","-2"
"182670","Dartmouth College","2019","Second major","'14'","Engineering","Bachelor's degree","3","3","0","0","0","0","1","1","0","0","0","0","0","0","0","0","0","0","1","1","0","1","1","0","0","0","0","0","0","0","-2"
"183026","Southern New Hampshire University","2019","First major","'14'","Engineering","Bachelor's degree","13","12","1","0","0","0","1","1","0","0","0","0","1","1","0","0","0","0","5","4","1","0","0","0","6","6","0","0","0","0","-2"
"183044","University of New Hampshire-Main Campus","2019","First major","'14'","Engineering","Bachelor's degree","335","257","78","0","0","0","15","8","7","4","3","1","8","7","1","0","0","0","265","208","57","4","4","0","16","15","1","23","12","11","-2"
"183044","University of New Hampshire-Main Campus","2019","First major","'14'","Engineering","Master's degree","59","40","19","0","0","0","2","2","0","1","0","1","1","1","0","0","0","0","33","24","9","0","0","0","1","1","0","21","12","9","-2"
"183044","University of New Hampshire-Main Campus","2019","First major","'14'","Engineering","Doctor's degree - research/scholarship","18","15","3","0","0","0","1","1","0","0","0","0","0","0","0","0","0","0","7","5","2","0","0","0","1","1","0","9","8","1","-2"
"183099","NHTI-Concord's Community College","2019","First major","'14'","Engineering","Associate's degree","7","7","0","0","0","0","0","0","0","0","0","0","0","0","0","0","0","0","7","7","0","0","0","0","0","0","0","0","0","0","-2"
"183150","Great Bay Community College","2019","First major","'14'","Engineering","Associate's degree","9","7","2","0","0","0","0","0","0","0","0","0","0","0","0","0","0","0","8","7","1","1","0","1","0","0","0","0","0","0","-2"
"183239","Saint Anselm College","2019","First major","'14'","Engineering","Bachelor's degree","6","6","0","0","0","0","0","0","0","0","0","0","0","0","0","0","0","0","6","6","0","0","0","0","0","0","0","0","0","0","-2"
"183655","Atlantic Cape Community College","2019","First major","'14'","Engineering","Associate's degree","11","9","2","2","2","0","2","1","1","1","1","0","2","2","0","0","0","0","3","2","1","0","0","0","1","1","0","0","0","0","-2"
"183859","Brookdale Community College","2019","First major","'14'","Engineering","Associate's degree","30","24","6","0","0","0","1","1","0","0","0","0","5","3","2","0","0","0","18","17","1","0","0","0","3","1","2","3","2","1","-2"
"183938","Camden County College","2019","First major","'14'","Engineering","Associate's degree","12","10","2","0","0","0","2","1","1","0","0","0","1","1","0","0","0","0","8","7","1","0","0","0","0","0","0","1","1","0","-2"
"184180","County College of Morris","2019","First major","'14'","Engineering","Associate's degree","28","25","3","0","0","0","2","2","0","1","1","0","4","3","1","0","0","0","18","17","1","0","0","0","3","2","1","0","0","0","-2"
"184205","Cumberland County College","2019","First major","'14'","Engineering","Associate's degree","7","6","1","0","0","0","0","0","0","1","1","0","4","3","1","0","0","0","2","2","0","0","0","0","0","0","0","0","0","0","-2"
"184481","Essex County College","2019","First major","'14'","Engineering","Associate's degree","21","16","5","0","0","0","0","0","0","4","3","1","7","6","1","0","0","0","1","1","0","0","0","0","2","1","1","7","5","2","-2"
"184603","Fairleigh Dickinson University-Metropolitan Campus","2019","First major","'14'","Engineering","Bachelor's degree","20","17","3","0","0","0","1","1","0","1","1","0","4","3","1","0","0","0","5","4","1","0","0","0","4","3","1","5","5","0","-2"
"184603","Fairleigh Dickinson University-Metropolitan Campus","2019","First major","'14'","Engineering","Master's degree","10","2","8","0","0","0","1","0","1","1","1","0","1","0","1","0","0","0","1","0","1","0","0","0","1","0","1","5","1","4","-2"
"184694","Fairleigh Dickinson University-Florham Campus","2019","First major","'14'","Engineering","Master's degree","0","0","0","0","0","0","0","0","0","0","0","0","0","0","0","0","0","0","0","0","0","0","0","0","0","0","0","0","0","0","-2"
"184782","Rowan University","2019","First major","'14'","Engineering","Bachelor's degree","299","246","53","0","0","0","13","10","3","4","4","0","10","8","2","0","0","0","251","208","43","10","7","3","6","5","1","5","4","1","-2"
"184782","Rowan University","2019","First major","'14'","Engineering","Master's degree","27","21","6","0","0","0","1","1","0","0","0","0","1","0","1","0","0","0","17","14","3","0","0","0","0","0","0","8","6","2","-2"
"184782","Rowan University","2019","First major","'14'","Engineering","Doctor's degree - research/scholarship","1","0","1","0","0","0","0","0","0","0","0","0","0","0","0","0","0","0","1","0","1","0","0","0","0","0","0","0","0","0","-2"
"184791","Rowan College of South Jersey Gloucester Campus","2019","First major","'14'","Engineering","Associate's degree","19","15","4","0","0","0","2","1","1","0","0","0","1","0","1","0","0","0","14","12","2","1","1","0","0","0","0","1","1","0","-2"
"184995","Hudson County Community College","2019","First major","'14'","Engineering","Associate's degree","28","22","6","0","0","0","1","1","0","0","0","0","14","9","5","0","0","0","9","8","1","0","0","0","2","2","0","2","2","0","-2"
"185509","Mercer County Community College","2019","First major","'14'","Engineering","Associate's degree","14","11","3","0","0","0","3","2","1","2","2","0","2","2","0","0","0","0","5","3","2","0","0","0","2","2","0","0","0","0","-2"
"185536","Middlesex County College","2019","First major","'14'","Engineering","Associate's degree","42","28","14","0","0","0","12","8","4","2","1","1","8","6","2","0","0","0","13","11","2","0","0","0","1","0","1","6","2","4","-2"
"185572","Monmouth University","2019","First major","'14'","Engineering","Bachelor's degree","12","9","3","0","0","0","2","2","0","0","0","0","3","2","1","0","0","0","6","4","2","0","0","0","1","1","0","0","0","0","-2"
"185572","Monmouth University","2019","First major","'14'","Engineering","Master's degree","16","9","7","0","0","0","1","1","0","0","0","0","0","0","0","0","0","0","9","6","3","0","0","0","0","0","0","6","2","4","-2"
"185572","Monmouth University","2019","Second major","'14'","Engineering","Bachelor's degree","1","1","0","0","0","0","0","0","0","0","0","0","1","1","0","0","0","0","0","0","0","0","0","0","0","0","0","0","0","0","-2"
"185828","New Jersey Institute of Technology","2019","First major","'14'","Engineering","Bachelor's degree","668","516","152","0","0","0","128","100","28","37","24","13","127","94","33","1","1","0","268","218","50","25","19","6","46","36","10","36","24","12","-2"
"185828","New Jersey Institute of Technology","2019","First major","'14'","Engineering","Master's degree","444","355","89","0","0","0","52","35","17","22","15","7","37","33","4","0","0","0","81","67","14","10","6","4","15","13","2","227","186","41","-2"
"185828","New Jersey Institute of Technology","2019","First major","'14'","Engineering","Doctor's degree - research/scholarship","36","26","10","0","0","0","3","3","0","1","1","0","1","1","0","0","0","0","7","4","3","0","0","0","2","2","0","22","15","7","-2"
"185873","Ocean County College","2019","First major","'14'","Engineering","Associate's degree","14","9","5","0","0","0","2","2","0","2","1","1","3","1","2","0","0","0","7","5","2","0","0","0","0","0","0","0","0","0","-2"
"186034","Passaic County Community College","2019","First major","'14'","Engineering","Associate's degree","5","3","2","0","0","0","0","0","0","1","0","1","0","0","0","0","0","0","3","3","0","0","0","0","1","0","1","0","0","0","-2"
"186131","Princeton University","2019","First major","'14'","Engineering","Bachelor's degree","218","135","83","0","0","0","66","36","30","8","5","3","21","10","11","0","0","0","86","56","30","6","5","1","1","1","0","30","22","8","-2"
"186131","Princeton University","2019","First major","'14'","Engineering","Master's degree","95","65","30","0","0","0","6","4","2","3","1","2","2","1","1","0","0","0","25","14","11","1","0","1","1","1","0","57","44","13","-2"
"186131","Princeton University","2019","First major","'14'","Engineering","Doctor's degree - research/scholarship","69","51","18","0","0","0","6","3","3","1","1","0","1","0","1","0","0","0","22","17","5","1","1","0","3","3","0","35","26","9","-2"
"186380","Rutgers University-New Brunswick","2019","First major","'14'","Engineering","Bachelor's degree","892","651","241","2","2","0","285","208","77","40","26","14","89","64","25","1","1","0","347","264","83","29","21","8","15","10","5","84","55","29","-2"
"186380","Rutgers University-New Brunswick","2019","First major","'14'","Engineering","Master's degree","320","223","97","0","0","0","37","27","10","5","2","3","10","7","3","0","0","0","55","36","19","5","5","0","1","1","0","207","145","62","-2"
"186380","Rutgers University-New Brunswick","2019","First major","'14'","Engineering","Doctor's degree - research/scholarship","88","67","21","0","0","0","5","5","0","1","1","0","2","2","0","0","0","0","20","14","6","0","0","0","0","0","0","60","45","15","-2"
"186399","Rutgers University-Newark","2019","First major","'14'","Engineering","Bachelor's degree","5","2","3","0","0","0","1","1","0","2","0","2","0","0","0","0","0","0","1","1","0","0","0","0","0","0","0","1","0","1","-2"
"186469","Salem Community College","2019","First major","'14'","Engineering","Associate's degree","1","1","0","0","0","0","0","0","0","0","0","0","0","0","0","0","0","0","1","1","0","0","0","0","0","0","0","0","0","0","-2"
"186645","Raritan Valley Community College","2019","First major","'14'","Engineering","Associate's degree","39","29","10","0","0","0","1","1","0","2","0","2","5","3","2","0","0","0","25","19","6","1","1","0","4","4","0","1","1","0","-2"
"186867","Stevens Institute of Technology","2019","First major","'14'","Engineering","Bachelor's degree","481","346","135","0","0","0","51","36","15","6","4","2","41","28","13","0","0","0","344","252","92","0","0","0","21","12","9","18","14","4","-2"
"186867","Stevens Institute of Technology","2019","First major","'14'","Engineering","Master's degree","575","457","118","1","1","0","33","25","8","11","9","2","4","3","1","0","0","0","162","127","35","0","0","0","123","93","30","241","199","42","-2"
"186867","Stevens Institute of Technology","2019","First major","'14'","Engineering","Doctor's degree - research/scholarship","28","23","5","0","0","0","1","1","0","1","1","0","0","0","0","0","0","0","3","2","1","0","0","0","4","3","1","19","16","3","-2"
"187134","The College of New Jersey","2019","First major","'14'","Engineering","Bachelor's degree","101","77","24","0","0","0","7","2","5","2","2","0","10","5","5","1","1","0","78","65","13","0","0","0","3","2","1","0","0","0","-2"
"187198","Union County College","2019","First major","'14'","Engineering","Associate's degree","68","52","16","0","0","0","2","2","0","9","9","0","38","31","7","0","0","0","12","6","6","1","1","0","5","3","2","1","0","1","-2"
"187532","Central New Mexico Community College","2019","First major","'14'","Engineering","Associate's degree","29","23","6","3","1","2","3","1","2","2","1","1","13","12","1","0","0","0","7","7","0","0","0","0","1","1","0","0","0","0","-2"
"187596","Navajo Technical University","2019","First major","'14'","Engineering","Bachelor's degree","2","1","1","2","1","1","0","0","0","0","0","0","0","0","0","0","0","0","0","0","0","0","0","0","0","0","0","0","0","0","-2"
"187620","New Mexico State University-Dona Ana","2019","First major","'14'","Engineering","Associate's degree","3","3","0","0","0","0","0","0","0","0","0","0","2","2","0","0","0","0","1","1","0","0","0","0","0","0","0","0","0","0","-2"
"187897","New Mexico Highlands University","2019","First major","'14'","Engineering","Associate's degree","0","0","0","0","0","0","0","0","0","0","0","0","0","0","0","0","0","0","0","0","0","0","0","0","0","0","0","0","0","0","-2"
"187897","New Mexico Highlands University","2019","First major","'14'","Engineering","Bachelor's degree","0","0","0","0","0","0","0","0","0","0","0","0","0","0","0","0","0","0","0","0","0","0","0","0","0","0","0","0","0","0","-2"
"187967","New Mexico Institute of Mining and Technology","2019","First major","'14'","Engineering","Bachelor's degree","188","142","46","5","4","1","4","4","0","4","3","1","51","34","17","0","0","0","103","84","19","9","5","4","5","4","1","7","4","3","-2"
"187967","New Mexico Institute of Mining and Technology","2019","First major","'14'","Engineering","Master's degree","61","44","17","0","0","0","5","4","1","0","0","0","6","4","2","0","0","0","33","23","10","1","1","0","1","1","0","15","11","4","-2"
"187967","New Mexico Institute of Mining and Technology","2019","First major","'14'","Engineering","Doctor's degree - research/scholarship","1","1","0","0","0","0","0","0","0","0","0","0","0","0","0","0","0","0","0","0","0","0","0","0","0","0","0","1","1","0","-2"
"187976","University of New Mexico-Los Alamos Campus","2019","First major","'14'","Engineering","Associate's degree","8","4","4","0","0","0","0","0","0","0","0","0","5","2","3","0","0","0","2","1","1","1","1","0","0","0","0","0","0","0","-2"
"187985","University of New Mexico-Main Campus","2019","First major","'14'","Engineering","Bachelor's degree","281","224","57","7","5","2","14","12","2","1","1","0","126","98","28","0","0","0","101","84","17","12","6","6","2","2","0","18","16","2","-2"
"187985","University of New Mexico-Main Campus","2019","First major","'14'","Engineering","Master's degree","177","128","49","3","1","2","8","6","2","1","1","0","40","27","13","0","0","0","77","60","17","4","3","1","5","3","2","39","27","12","-2"
"187985","University of New Mexico-Main Campus","2019","First major","'14'","Engineering","Doctor's degree - research/scholarship","33","29","4","0","0","0","1","1","0","0","0","0","2","1","1","0","0","0","12","11","1","2","0","2","1","1","0","15","15","0","-2"
"187994","New Mexico State University-Alamogordo","2019","First major","'14'","Engineering","Associate's degree","1","1","0","0","0","0","0","0","0","0","0","0","1","1","0","0","0","0","0","0","0","0","0","0","0","0","0","0","0","0","-2"
"188003","New Mexico State University-Carlsbad","2019","First major","'14'","Engineering","Associate's degree","3","3","0","0","0","0","0","0","0","0","0","0","2","2","0","0","0","0","1","1","0","0","0","0","0","0","0","0","0","0","-2"
"188021","New Mexico State University-Grants","2019","First major","'14'","Engineering","Associate's degree","0","0","0","0","0","0","0","0","0","0","0","0","0","0","0","0","0","0","0","0","0","0","0","0","0","0","0","0","0","0","-2"
"188030","New Mexico State University-Main Campus","2019","First major","'14'","Engineering","Bachelor's degree","333","285","48","4","4","0","6","5","1","5","4","1","134","109","25","0","0","0","82","69","13","7","5","2","1","1","0","94","88","6","-2"
"188030","New Mexico State University-Main Campus","2019","First major","'14'","Engineering","Master's degree","112","85","27","3","3","0","6","3","3","1","1","0","35","25","10","0","0","0","35","30","5","1","1","0","1","1","0","30","21","9","-2"
"188030","New Mexico State University-Main Campus","2019","First major","'14'","Engineering","Doctor's degree - research/scholarship","21","19","2","0","0","0","2","2","0","1","1","0","3","3","0","0","0","0","5","4","1","0","0","0","0","0","0","10","9","1","-2"
"188049","University of New Mexico-Valencia County Campus","2019","First major","'14'","Engineering","Associate's degree","2","2","0","0","0","0","0","0","0","0","0","0","1","1","0","0","0","0","1","1","0","0","0","0","0","0","0","0","0","0","-2"
"188058","Northern New Mexico College","2019","First major","'14'","Engineering","Associate's degree","6","6","0","1","1","0","0","0","0","0","0","0","5","5","0","0","0","0","0","0","0","0","0","0","0","0","0","0","0","0","-2"
"188100","San Juan College","2019","First major","'14'","Engineering","Associate's degree","9","7","2","3","2","1","0","0","0","0","0","0","1","1","0","0","0","0","1","1","0","0","0","0","3","2","1","1","1","0","-2"
"188137","Santa Fe Community College","2019","First major","'14'","Engineering","Associate's degree","8","5","3","0","0","0","1","0","1","0","0","0","3","2","1","0","0","0","4","3","1","0","0","0","0","0","0","0","0","0","-2"
"188216","Southwestern Indian Polytechnic Institute","2019","First major","'14'","Engineering","Associate's degree","5","3","2","5","3","2","0","0","0","0","0","0","0","0","0","0","0","0","0","0","0","0","0","0","0","0","0","0","0","0","-2"
"188340","Vaughn College of Aeronautics and Technology","2019","First major","'14'","Engineering","Bachelor's degree","19","17","2","0","0","0","2","2","0","0","0","0","5","5","0","0","0","0","3","2","1","3","2","1","4","4","0","2","2","0","-2"
"188438","SUNY Adirondack","2019","First major","'14'","Engineering","Associate's degree","17","16","1","0","0","0","0","0","0","0","0","0","1","1","0","0","0","0","15","14","1","1","1","0","0","0","0","0","0","0","-2"
"188641","Alfred University","2019","First major","'14'","Engineering","Bachelor's degree","85","69","16","0","0","0","3","2","1","0","0","0","7","6","1","0","0","0","64","52","12","0","0","0","10","9","1","1","0","1","-2"
"188641","Alfred University","2019","First major","'14'","Engineering","Master's degree","8","6","2","0","0","0","1","1","0","0","0","0","0","0","0","0","0","0","6","5","1","0","0","0","0","0","0","1","0","1","-2"
"188641","Alfred University","2019","First major","'14'","Engineering","Doctor's degree - research/scholarship","5","3","2","0","0","0","0","0","0","0","0","0","0","0","0","0","0","0","2","1","1","0","0","0","0","0","0","3","2","1","-2"
"189547","SUNY Broome Community College","2019","First major","'14'","Engineering","Associate's degree","33","27","6","0","0","0","2","2","0","2","2","0","2","1","1","0","0","0","23","19","4","0","0","0","0","0","0","4","3","1","-2"
"189705","Canisius College","2019","First major","'14'","Engineering","Bachelor's degree","2","1","1","0","0","0","0","0","0","0","0","0","0","0","0","0","0","0","2","1","1","0","0","0","0","0","0","0","0","0","-2"
"189839","Cayuga County Community College","2019","First major","'14'","Engineering","Associate's degree","0","0","0","0","0","0","0","0","0","0","0","0","0","0","0","0","0","0","0","0","0","0","0","0","0","0","0","0","0","0","-2"
"190044","Clarkson University","2019","First major","'14'","Engineering","Bachelor's degree","390","305","85","1","1","0","11","7","4","5","5","0","10","7","3","0","0","0","341","268","73","8","8","0","8","6","2","6","3","3","-2"
"190044","Clarkson University","2019","First major","'14'","Engineering","Master's degree","68","57","11","0","0","0","1","1","0","1","1","0","5","4","1","0","0","0","41","34","7","1","1","0","6","5","1","13","11","2","-2"
"190044","Clarkson University","2019","First major","'14'","Engineering","Doctor's degree - research/scholarship","20","13","7","0","0","0","1","0","1","0","0","0","1","1","0","0","0","0","2","2","0","0","0","0","0","0","0","16","10","6","-2"
"190044","Clarkson University","2019","Second major","'14'","Engineering","Bachelor's degree","33","24","9","0","0","0","1","0","1","1","1","0","1","1","0","0","0","0","29","21","8","1","1","0","0","0","0","0","0","0","-2"
"190150","Columbia University in the City of New York","2019","First major","'14'","Engineering","Bachelor's degree","315","177","138","0","0","0","58","25","33","18","7","11","43","25","18","0","0","0","83","48","35","14","8","6","24","18","6","75","46","29","-2"
"190150","Columbia University in the City of New York","2019","First major","'14'","Engineering","Master's degree","1034","675","359","0","0","0","40","28","12","7","5","2","12","7","5","0","0","0","82","67","15","5","4","1","45","32","13","843","532","311","-2"
"190150","Columbia University in the City of New York","2019","First major","'14'","Engineering","Doctor's degree - research/scholarship","88","67","21","0","0","0","10","8","2","1","1","0","5","2","3","0","0","0","11","9","2","1","0","1","4","2","2","56","45","11","-2"
"190150","Columbia University in the City of New York","2019","Second major","'14'","Engineering","Bachelor's degree","2","0","2","0","0","0","0","0","0","0","0","0","0","0","0","0","0","0","1","0","1","0","0","0","1","0","1","0","0","0","-2"
"190372","Cooper Union for the Advancement of Science and Art","2019","First major","'14'","Engineering","Bachelor's degree","118","92","26","0","0","0","30","24","6","0","0","0","1","1","0","0","0","0","34","25","9","13","11","2","11","9","2","29","22","7","-2"
"190372","Cooper Union for the Advancement of Science and Art","2019","First major","'14'","Engineering","Master's degree","32","25","7","0","0","0","8","6","2","2","2","0","3","3","0","0","0","0","10","9","1","0","0","0","4","2","2","5","3","2","-2"
"190415","Cornell University","2019","First major","'14'","Engineering","Bachelor's degree","581","318","263","2","1","1","153","72","81","17","9","8","88","64","24","0","0","0","215","123","92","26","8","18","33","18","15","47","23","24","-2"
"190415","Cornell University","2019","First major","'14'","Engineering","Master's degree","708","448","260","2","1","1","76","50","26","15","7","8","41","24","17","1","1","0","180","126","54","13","8","5","17","12","5","363","219","144","-2"
"190415","Cornell University","2019","First major","'14'","Engineering","Doctor's degree - research/scholarship","137","97","40","0","0","0","13","8","5","2","1","1","5","4","1","0","0","0","49","32","17","4","3","1","8","6","2","56","43","13","-2"
"190415","Cornell University","2019","Second major","'14'","Engineering","Bachelor's degree","9","8","1","0","0","0","2","2","0","0","0","0","1","1","0","0","0","0","2","1","1","1","1","0","1","1","0","2","2","0","-2"
"190424","Weill Medical College of Cornell University","2019","First major","'14'","Engineering","Master's degree","1","0","1","0","0","0","0","0","0","0","0","0","0","0","0","0","0","0","1","0","1","0","0","0","0","0","0","0","0","0","-2"
"190424","Weill Medical College of Cornell University","2019","First major","'14'","Engineering","Doctor's degree - research/scholarship","10","5","5","0","0","0","0","0","0","0","0","0","0","0","0","0","0","0","5","3","2","1","0","1","0","0","0","4","2","2","-2"
"190442","SUNY Corning Community College","2019","First major","'14'","Engineering","Associate's degree","8","8","0","0","0","0","0","0","0","0","0","0","0","0","0","0","0","0","8","8","0","0","0","0","0","0","0","0","0","0","-2"
"190512","CUNY Bernard M Baruch College","2019","First major","'14'","Engineering","Bachelor's degree","0","0","0","0","0","0","0","0","0","0","0","0","0","0","0","0","0","0","0","0","0","0","0","0","0","0","0","0","0","0","-2"
"190512","CUNY Bernard M Baruch College","2019","First major","'14'","Engineering","Master's degree","36","18","18","0","0","0","11","7","4","0","0","0","1","1","0","0","0","0","3","2","1","0","0","0","0","0","0","21","8","13","-2"
"190521","CUNY Borough of Manhattan Community College","2019","First major","'14'","Engineering","Associate's degree","54","46","8","1","1","0","10","9","1","14","12","2","12","12","0","0","0","0","3","3","0","1","1","0","0","0","0","13","8","5","-2"
"190530","CUNY Bronx Community College","2019","First major","'14'","Engineering","Associate's degree","23","22","1","0","0","0","2","2","0","8","8","0","11","10","1","0","0","0","1","1","0","0","0","0","0","0","0","1","1","0","-2"
"190558","College of Staten Island CUNY","2019","First major","'14'","Engineering","Associate's degree","2","2","0","0","0","0","1","1","0","0","0","0","1","1","0","0","0","0","0","0","0","0","0","0","0","0","0","0","0","0","-2"
"190558","College of Staten Island CUNY","2019","First major","'14'","Engineering","Bachelor's degree","63","47","16","0","0","0","6","5","1","9","5","4","11","8","3","0","0","0","32","24","8","2","2","0","0","0","0","3","3","0","-2"
"190558","College of Staten Island CUNY","2019","First major","'14'","Engineering","Master's degree","2","2","0","0","0","0","0","0","0","0","0","0","0","0","0","0","0","0","2","2","0","0","0","0","0","0","0","0","0","0","-2"
"190567","CUNY City College","2019","First major","'14'","Engineering","Bachelor's degree","487","383","104","1","1","0","170","143","27","47","39","8","122","86","36","4","4","0","99","75","24","7","5","2","0","0","0","37","30","7","-2"
"190567","CUNY City College","2019","First major","'14'","Engineering","Master's degree","115","82","33","0","0","0","33","26","7","7","5","2","15","10","5","0","0","0","27","19","8","1","1","0","0","0","0","32","21","11","-2"
"190567","CUNY City College","2019","First major","'14'","Engineering","Doctor's degree - research/scholarship","26","18","8","0","0","0","2","1","1","1","1","0","1","1","0","0","0","0","6","5","1","0","0","0","0","0","0","16","10","6","-2"
"190576","CUNY Graduate School and University Center","2019","First major","'14'","Engineering","Bachelor's degree","0","0","0","0","0","0","0","0","0","0","0","0","0","0","0","0","0","0","0","0","0","0","0","0","0","0","0","0","0","0","-2"
"190576","CUNY Graduate School and University Center","2019","First major","'14'","Engineering","Master's degree","0","0","0","0","0","0","0","0","0","0","0","0","0","0","0","0","0","0","0","0","0","0","0","0","0","0","0","0","0","0","-2"
"190576","CUNY Graduate School and University Center","2019","First major","'14'","Engineering","Doctor's degree - research/scholarship","0","0","0","0","0","0","0","0","0","0","0","0","0","0","0","0","0","0","0","0","0","0","0","0","0","0","0","0","0","0","-2"
"190585","CUNY Hostos Community College","2019","First major","'14'","Engineering","Associate's degree","29","21","8","0","0","0","0","0","0","5","4","1","15","10","5","0","0","0","1","1","0","1","1","0","0","0","0","7","5","2","-2"
"190619","CUNY Kingsborough Community College","2019","First major","'14'","Engineering","Associate's degree","20","17","3","0","0","0","4","4","0","5","5","0","3","2","1","0","0","0","6","4","2","0","0","0","0","0","0","2","2","0","-2"
"190628","CUNY LaGuardia Community College","2019","First major","'14'","Engineering","Associate's degree","109","92","17","0","0","0","34","24","10","11","10","1","27","25","2","0","0","0","14","12","2","2","2","0","0","0","0","21","19","2","-2"
"190673","CUNY Queensborough Community College","2019","First major","'14'","Engineering","Associate's degree","18","16","2","0","0","0","6","6","0","1","1","0","7","7","0","0","0","0","1","1","0","1","1","0","0","0","0","2","0","2","-2"
"190840","Dutchess Community College","2019","First major","'14'","Engineering","Associate's degree","20","17","3","0","0","0","3","2","1","0","0","0","5","4","1","0","0","0","11","10","1","1","1","0","0","0","0","0","0","0","-2"
"191083","Erie Community College","2019","First major","'14'","Engineering","Associate's degree","15","12","3","0","0","0","0","0","0","0","0","0","0","0","0","0","0","0","13","10","3","0","0","0","1","1","0","1","1","0","-2"
"191199","Finger Lakes Community College","2019","First major","'14'","Engineering","Associate's degree","8","6","2","0","0","0","1","1","0","0","0","0","1","0","1","0","0","0","6","5","1","0","0","0","0","0","0","0","0","0","-2"
"191241","Fordham University","2019","First major","'14'","Engineering","Bachelor's degree","14","9","5","0","0","0","3","3","0","0","0","0","0","0","0","0","0","0","11","6","5","0","0","0","0","0","0","0","0","0","-2"
"191339","Genesee Community College","2019","First major","'14'","Engineering","Associate's degree","2","2","0","0","0","0","0","0","0","0","0","0","0","0","0","0","0","0","2","2","0","0","0","0","0","0","0","0","0","0","-2"
"191612","Herkimer County Community College","2019","First major","'14'","Engineering","Associate's degree","1","0","1","0","0","0","0","0","0","0","0","0","0","0","0","0","0","0","1","0","1","0","0","0","0","0","0","0","0","0","-2"
"191649","Hofstra University","2019","First major","'14'","Engineering","Bachelor's degree","106","76","30","2","2","0","15","11","4","5","5","0","12","7","5","0","0","0","61","45","16","3","1","2","2","2","0","6","3","3","-2"
"191676","Houghton College","2019","First major","'14'","Engineering","Bachelor's degree","0","0","0","0","0","0","0","0","0","0","0","0","0","0","0","0","0","0","0","0","0","0","0","0","0","0","0","0","0","0","-2"
"191719","Hudson Valley Community College","2019","First major","'14'","Engineering","Associate's degree","40","35","5","0","0","0","0","0","0","2","2","0","1","1","0","0","0","0","35","30","5","2","2","0","0","0","0","0","0","0","-2"
"191986","Jamestown Community College","2019","First major","'14'","Engineering","Associate's degree","2","2","0","0","0","0","0","0","0","0","0","0","0","0","0","0","0","0","2","2","0","0","0","0","0","0","0","0","0","0","-2"
"192022","Jefferson Community College","2019","First major","'14'","Engineering","Associate's degree","8","8","0","0","0","0","0","0","0","0","0","0","1","1","0","0","0","0","7","7","0","0","0","0","0","0","0","0","0","0","-2"
"192448","Long Island University","2019","First major","'14'","Engineering","Bachelor's degree","0","0","0","0","0","0","0","0","0","0","0","0","0","0","0","0","0","0","0","0","0","0","0","0","0","0","0","0","0","0","-2"
"192448","Long Island University","2019","First major","'14'","Engineering","Master's degree","5","5","0","0","0","0","0","0","0","0","0","0","0","0","0","0","0","0","0","0","0","0","0","0","0","0","0","5","5","0","-2"
"192703","Manhattan College","2019","First major","'14'","Engineering","Bachelor's degree","298","218","80","0","0","0","40","26","14","12","6","6","61","46","15","0","0","0","155","114","41","8","5","3","22","21","1","0","0","0","-2"
"192703","Manhattan College","2019","First major","'14'","Engineering","Master's degree","86","66","20","0","0","0","12","6","6","2","2","0","9","9","0","0","0","0","42","33","9","0","0","0","21","16","5","0","0","0","-2"
"193283","Mohawk Valley Community College","2019","First major","'14'","Engineering","Associate's degree","19","17","2","0","0","0","0","0","0","1","1","0","1","1","0","0","0","0","15","14","1","0","0","0","0","0","0","2","1","1","-2"
"193326","Monroe Community College","2019","First major","'14'","Engineering","Associate's degree","56","48","8","1","1","0","3","3","0","1","1","0","0","0","0","0","0","0","45","40","5","4","2","2","0","0","0","2","1","1","-2"
"193478","Nassau Community College","2019","First major","'14'","Engineering","Associate's degree","23","19","4","0","0","0","4","3","1","3","3","0","8","6","2","0","0","0","5","4","1","0","0","0","1","1","0","2","2","0","-2"
"193900","New York University","2019","First major","'14'","Engineering","Bachelor's degree","261","179","82","0","0","0","86","56","30","8","6","2","20","13","7","1","0","1","56","42","14","9","5","4","25","16","9","56","41","15","-2"
"193900","New York University","2019","First major","'14'","Engineering","Master's degree","372","249","123","0","0","0","19","12","7","4","3","1","9","5","4","0","0","0","45","32","13","4","3","1","7","5","2","284","189","95","-2"
"193900","New York University","2019","First major","'14'","Engineering","Doctor's degree - research/scholarship","31","25","6","0","0","0","0","0","0","0","0","0","1","1","0","0","0","0","3","3","0","0","0","0","1","1","0","26","20","6","-2"
"193946","Niagara County Community College","2019","First major","'14'","Engineering","Associate's degree","12","10","2","0","0","0","2","2","0","0","0","0","0","0","0","0","0","0","9","8","1","0","0","0","1","0","1","0","0","0","-2"
"194091","New York Institute of Technology","2019","First major","'14'","Engineering","Bachelor's degree","102","95","7","1","1","0","25","25","0","8","8","0","8","8","0","0","0","0","28","27","1","0","0","0","10","10","0","22","16","6","-2"
"194091","New York Institute of Technology","2019","First major","'14'","Engineering","Master's degree","74","60","14","0","0","0","7","7","0","2","2","0","2","2","0","0","0","0","7","7","0","1","1","0","0","0","0","55","41","14","-2"
"194222","Onondaga Community College","2019","First major","'14'","Engineering","Associate's degree","13","12","1","1","1","0","1","1","0","1","1","0","1","1","0","0","0","0","8","7","1","1","1","0","0","0","0","0","0","0","-2"
"194240","Orange County Community College","2019","First major","'14'","Engineering","Associate's degree","23","20","3","0","0","0","0","0","0","2","1","1","5","5","0","0","0","0","15","13","2","1","1","0","0","0","0","0","0","0","-2"
"194310","Pace University","2019","First major","'14'","Engineering","Master's degree","6","4","2","0","0","0","0","0","0","1","1","0","0","0","0","0","0","0","4","2","2","0","0","0","0","0","0","1","1","0","-2"
"194824","Rensselaer Polytechnic Institute","2019","First major","'14'","Engineering","Bachelor's degree","697","459","238","0","0","0","52","33","19","24","19","5","57","43","14","0","0","0","425","283","142","53","22","31","13","10","3","73","49","24","-2"
"194824","Rensselaer Polytechnic Institute","2019","First major","'14'","Engineering","Master's degree","111","76","35","0","0","0","10","7","3","3","2","1","4","3","1","0","0","0","58","38","20","8","5","3","1","1","0","27","20","7","-2"
"194824","Rensselaer Polytechnic Institute","2019","First major","'14'","Engineering","Doctor's degree - research/scholarship","85","66","19","0","0","0","5","4","1","1","1","0","0","0","0","0","0","0","28","18","10","1","1","0","3","1","2","47","41","6","-2"
"195003","Rochester Institute of Technology","2019","First major","'14'","Engineering","Bachelor's degree","617","490","127","1","0","1","55","41","14","10","6","4","25","23","2","0","0","0","459","364","95","15","11","4","15","11","4","37","34","3","-2"
"195003","Rochester Institute of Technology","2019","First major","'14'","Engineering","Master's degree","282","235","47","0","0","0","12","10","2","2","1","1","7","7","0","0","0","0","124","104","20","4","4","0","4","3","1","129","106","23","-2"
"195003","Rochester Institute of Technology","2019","First major","'14'","Engineering","Doctor's degree - research/scholarship","9","8","1","0","0","0","1","0","1","0","0","0","0","0","0","0","0","0","4","4","0","0","0","0","0","0","0","4","4","0","-2"
"195003","Rochester Institute of Technology","2019","Second major","'14'","Engineering","Bachelor's degree","1","1","0","0","0","0","0","0","0","0","0","0","0","0","0","0","0","0","1","1","0","0","0","0","0","0","0","0","0","0","-2"
"195030","University of Rochester","2019","First major","'14'","Engineering","Bachelor's degree","281","188","93","0","0","0","30","18","12","7","4","3","24","13","11","0","0","0","138","93","45","5","4","1","21","15","6","56","41","15","-2"
"195030","University of Rochester","2019","First major","'14'","Engineering","Master's degree","102","71","31","0","0","0","3","3","0","4","3","1","6","4","2","0","0","0","37","23","14","1","1","0","8","6","2","43","31","12","-2"
"195030","University of Rochester","2019","First major","'14'","Engineering","Doctor's degree - research/scholarship","19","11","8","0","0","0","2","2","0","0","0","0","0","0","0","0","0","0","7","4","3","0","0","0","1","0","1","9","5","4","-2"
"195058","Rockland Community College","2019","First major","'14'","Engineering","Associate's degree","16","15","1","0","0","0","4","4","0","2","2","0","4","4","0","0","0","0","3","3","0","1","1","0","1","1","0","1","0","1","-2"
"195058","Rockland Community College","2019","Second major","'14'","Engineering","Associate's degree","1","0","1","0","0","0","0","0","0","1","0","1","0","0","0","0","0","0","0","0","0","0","0","0","0","0","0","0","0","0","-2"
"195474","Siena College","2019","First major","'14'","Engineering","Bachelor's degree","0","0","0","0","0","0","0","0","0","0","0","0","0","0","0","0","0","0","0","0","0","0","0","0","0","0","0","0","0","0","-2"
"196006","SUNY College of Technology at Alfred","2019","First major","'14'","Engineering","Associate's degree","4","2","2","0","0","0","1","0","1","0","0","0","0","0","0","0","0","0","3","2","1","0","0","0","0","0","0","0","0","0","-2"
"196015","SUNY College of Technology at Canton","2019","First major","'14'","Engineering","Associate's degree","6","6","0","0","0","0","0","0","0","0","0","0","0","0","0","0","0","0","6","6","0","0","0","0","0","0","0","0","0","0","-2"
"196015","SUNY College of Technology at Canton","2019","First major","'14'","Engineering","Bachelor's degree","0","0","0","0","0","0","0","0","0","0","0","0","0","0","0","0","0","0","0","0","0","0","0","0","0","0","0","0","0","0","-2"
"196024","SUNY College of Technology at Delhi","2019","First major","'14'","Engineering","Associate's degree","0","0","0","0","0","0","0","0","0","0","0","0","0","0","0","0","0","0","0","0","0","0","0","0","0","0","0","0","0","0","-2"
"196051","SUNY Morrisville","2019","First major","'14'","Engineering","Associate's degree","2","1","1","0","0","0","0","0","0","0","0","0","0","0","0","0","0","0","2","1","1","0","0","0","0","0","0","0","0","0","-2"
"196060","SUNY at Albany","2019","First major","'14'","Engineering","Bachelor's degree","12","12","0","0","0","0","2","2","0","1","1","0","1","1","0","0","0","0","8","8","0","0","0","0","0","0","0","0","0","0","-2"
"196060","SUNY at Albany","2019","First major","'14'","Engineering","Master's degree","2","0","2","0","0","0","0","0","0","0","0","0","0","0","0","0","0","0","1","0","1","0","0","0","0","0","0","1","0","1","-2"
"196060","SUNY at Albany","2019","First major","'14'","Engineering","Doctor's degree - research/scholarship","8","7","1","0","0","0","0","0","0","0","0","0","0","0","0","0","0","0","3","3","0","1","1","0","0","0","0","4","3","1","-2"
"196079","Binghamton University","2019","First major","'14'","Engineering","Bachelor's degree","359","276","83","0","0","0","47","37","10","14","10","4","31","28","3","0","0","0","246","186","60","5","3","2","5","4","1","11","8","3","-2"
"196079","Binghamton University","2019","First major","'14'","Engineering","Master's degree","218","178","40","0","0","0","14","12","2","8","5","3","13","12","1","0","0","0","58","52","6","1","1","0","2","1","1","122","95","27","-2"
"196079","Binghamton University","2019","First major","'14'","Engineering","Doctor's degree - research/scholarship","35","28","7","0","0","0","3","2","1","0","0","0","0","0","0","0","0","0","4","3","1","0","0","0","2","2","0","26","21","5","-2"
"196088","University at Buffalo","2019","First major","'14'","Engineering","Bachelor's degree","792","659","133","2","1","1","102","85","17","40","34","6","52","42","10","1","1","0","436","368","68","17","14","3","47","38","9","95","76","19","-2"
"196088","University at Buffalo","2019","First major","'14'","Engineering","Master's degree","440","330","110","0","0","0","19","14","5","6","3","3","5","4","1","0","0","0","67","50","17","2","1","1","8","6","2","333","252","81","-2"
"196088","University at Buffalo","2019","First major","'14'","Engineering","Doctor's degree - research/scholarship","85","67","18","0","0","0","0","0","0","1","0","1","0","0","0","0","0","0","18","14","4","0","0","0","4","4","0","62","49","13","-2"
"196088","University at Buffalo","2019","Second major","'14'","Engineering","Bachelor's degree","47","42","5","0","0","0","6","6","0","2","2","0","3","3","0","0","0","0","28","23","5","2","2","0","3","3","0","3","3","0","-2"
"196097","Stony Brook University","2019","First major","'14'","Engineering","Bachelor's degree","448","358","90","1","1","0","150","119","31","26","22","4","37","26","11","0","0","0","126","112","14","9","7","2","41","32","9","58","39","19","-2"
"196097","Stony Brook University","2019","First major","'14'","Engineering","Master's degree","328","247","81","0","0","0","41","30","11","6","4","2","19","15","4","0","0","0","68","52","16","4","3","1","22","19","3","168","124","44","-2"
"196097","Stony Brook University","2019","First major","'14'","Engineering","Doctor's degree - research/scholarship","61","40","21","0","0","0","5","2","3","2","1","1","1","0","1","0","0","0","11","7","4","1","1","0","3","3","0","38","26","12","-2"
"196103","SUNY College of Environmental Science and Forestry","2019","First major","'14'","Engineering","Bachelor's degree","89","52","37","1","1","0","4","2","2","0","0","0","1","0","1","0","0","0","49","33","16","1","0","1","3","2","1","30","14","16","-2"
"196103","SUNY College of Environmental Science and Forestry","2019","First major","'14'","Engineering","Master's degree","15","11","4","0","0","0","0","0","0","1","0","1","0","0","0","0","0","0","7","6","1","1","0","1","0","0","0","6","5","1","-2"
"196103","SUNY College of Environmental Science and Forestry","2019","First major","'14'","Engineering","Doctor's degree - research/scholarship","2","1","1","0","0","0","0","0","0","0","0","0","0","0","0","0","0","0","0","0","0","0","0","0","0","0","0","2","1","1","-2"
"196112","SUNY Polytechnic Institute","2019","First major","'14'","Engineering","Bachelor's degree","86","73","13","0","0","0","8","6","2","2","1","1","8","8","0","0","0","0","64","55","9","1","0","1","0","0","0","3","3","0","-2"
"196112","SUNY Polytechnic Institute","2019","First major","'14'","Engineering","Master's degree","4","3","1","0","0","0","0","0","0","0","0","0","1","1","0","0","0","0","3","2","1","0","0","0","0","0","0","0","0","0","-2"
"196112","SUNY Polytechnic Institute","2019","First major","'14'","Engineering","Doctor's degree - research/scholarship","7","5","2","0","0","0","1","0","1","0","0","0","1","0","1","0","0","0","3","3","0","0","0","0","0","0","0","2","2","0","-2"
"196130","SUNY Buffalo State","2019","First major","'14'","Engineering","Master's degree","12","9","3","0","0","0","1","1","0","3","3","0","1","1","0","0","0","0","3","2","1","1","1","0","0","0","0","3","1","2","-2"
"196176","State University of New York at New Paltz","2019","First major","'14'","Engineering","Bachelor's degree","86","73","13","0","0","0","7","3","4","4","4","0","18","15","3","1","1","0","53","48","5","0","0","0","2","1","1","1","1","0","-2"
"196176","State University of New York at New Paltz","2019","First major","'14'","Engineering","Master's degree","10","6","4","0","0","0","0","0","0","1","1","0","0","0","0","0","0","0","2","1","1","0","0","0","0","0","0","7","4","3","-2"
"196194","SUNY College at Oswego","2019","First major","'14'","Engineering","Bachelor's degree","30","29","1","0","0","0","4","4","0","2","2","0","2","2","0","0","0","0","20","19","1","1","1","0","0","0","0","1","1","0","-2"
"196255","SUNY Downstate Health Sciences University","2019","First major","'14'","Engineering","Doctor's degree - research/scholarship","0","0","0","0","0","0","0","0","0","0","0","0","0","0","0","0","0","0","0","0","0","0","0","0","0","0","0","0","0","0","-2"
"196291","SUNY Maritime College","2019","First major","'14'","Engineering","Bachelor's degree","158","139","19","0","0","0","11","10","1","8","8","0","25","21","4","0","0","0","104","91","13","4","4","0","3","3","0","3","2","1","-2"
"196413","Syracuse University","2019","First major","'14'","Engineering","Bachelor's degree","269","190","79","0","0","0","29","20","9","18","11","7","29","22","7","0","0","0","154","110","44","2","0","2","8","7","1","29","20","9","-2"
"196413","Syracuse University","2019","First major","'14'","Engineering","Master's degree","242","194","48","0","0","0","7","6","1","4","4","0","4","3","1","0","0","0","39","30","9","2","2","0","2","2","0","184","147","37","-2"
"196413","Syracuse University","2019","First major","'14'","Engineering","Doctor's degree - research/scholarship","26","21","5","0","0","0","0","0","0","0","0","0","1","0","1","0","0","0","7","7","0","0","0","0","1","0","1","17","14","3","-2"
"196565","Tompkins Cortland Community College","2019","First major","'14'","Engineering","Associate's degree","9","9","0","0","0","0","0","0","0","3","3","0","0","0","0","0","0","0","6","6","0","0","0","0","0","0","0","0","0","0","-2"
"196699","Ulster County Community College","2019","First major","'14'","Engineering","Associate's degree","11","10","1","0","0","0","1","1","0","0","0","0","3","3","0","0","0","0","6","5","1","1","1","0","0","0","0","0","0","0","-2"
"196866","Union College","2019","First major","'14'","Engineering","Bachelor's degree","113","86","27","0","0","0","6","2","4","3","2","1","2","2","0","0","0","0","84","65","19","7","6","1","0","0","0","11","9","2","-2"
"197027","United States Merchant Marine Academy","2019","First major","'14'","Engineering","Bachelor's degree","89","74","15","1","1","0","8","6","2","1","1","0","6","5","1","0","0","0","68","56","12","0","0","0","5","5","0","0","0","0","-2"
"197027","United States Merchant Marine Academy","2019","First major","'14'","Engineering","Master's degree","2","2","0","0","0","0","0","0","0","0","0","0","0","0","0","0","0","0","1","1","0","0","0","0","1","1","0","0","0","0","-2"
"197036","United States Military Academy","2019","First major","'14'","Engineering","Bachelor's degree","294","246","48","2","2","0","23","20","3","15","12","3","28","23","5","0","0","0","215","178","37","5","5","0","2","2","0","4","4","0","-2"
"197036","United States Military Academy","2019","Second major","'14'","Engineering","Bachelor's degree","1","0","1","0","0","0","0","0","0","0","0","0","1","0","1","0","0","0","0","0","0","0","0","0","0","0","0","0","0","0","-2"
"197221","Webb Institute","2019","First major","'14'","Engineering","Bachelor's degree","21","15","6","0","0","0","5","4","1","0","0","0","0","0","0","0","0","0","14","9","5","2","2","0","0","0","0","0","0","0","-2"
"197294","SUNY Westchester Community College","2019","First major","'14'","Engineering","Associate's degree","32","25","7","0","0","0","1","1","0","1","1","0","15","11","4","0","0","0","12","10","2","0","0","0","2","1","1","1","1","0","-2"
"197708","Yeshiva University","2019","First major","'14'","Engineering","Bachelor's degree","1","1","0","0","0","0","0","0","0","0","0","0","0","0","0","0","0","0","1","1","0","0","0","0","0","0","0","0","0","0","-2"
"197814","College of the Albemarle","2019","First major","'14'","Engineering","Associate's degree","10","9","1","0","0","0","0","0","0","0","0","0","1","1","0","0","0","0","9","8","1","0","0","0","0","0","0","0","0","0","-2"
"197850","South Piedmont Community College","2019","First major","'14'","Engineering","Associate's degree","0","0","0","0","0","0","0","0","0","0","0","0","0","0","0","0","0","0","0","0","0","0","0","0","0","0","0","0","0","0","-2"
"197887","Asheville-Buncombe Technical Community College","2019","First major","'14'","Engineering","Associate's degree","13","11","2","1","1","0","0","0","0","0","0","0","2","2","0","0","0","0","9","7","2","0","0","0","1","1","0","0","0","0","-2"
"198039","Blue Ridge Community College","2019","First major","'14'","Engineering","Associate's degree","7","6","1","0","0","0","1","1","0","1","1","0","1","0","1","0","0","0","1","1","0","0","0","0","2","2","0","1","1","0","-2"
"198084","Brunswick Community College","2019","First major","'14'","Engineering","Associate's degree","4","3","1","0","0","0","0","0","0","0","0","0","0","0","0","0","0","0","4","3","1","0","0","0","0","0","0","0","0","0","-2"
"198136","Campbell University","2019","First major","'14'","Engineering","Bachelor's degree","0","0","0","0","0","0","0","0","0","0","0","0","0","0","0","0","0","0","0","0","0","0","0","0","0","0","0","0","0","0","-2"
"198154","Cape Fear Community College","2019","First major","'14'","Engineering","Associate's degree","4","4","0","0","0","0","0","0","0","0","0","0","1","1","0","0","0","0","2","2","0","0","0","0","1","1","0","0","0","0","-2"
"198233","Catawba Valley Community College","2019","First major","'14'","Engineering","Associate's degree","3","2","1","0","0","0","0","0","0","0","0","0","0","0","0","0","0","0","2","1","1","1","1","0","0","0","0","0","0","0","-2"
"198251","Central Carolina Community College","2019","First major","'14'","Engineering","Associate's degree","11","11","0","0","0","0","0","0","0","0","0","0","2","2","0","0","0","0","8","8","0","0","0","0","1","1","0","0","0","0","-2"
"198260","Central Piedmont Community College","2019","First major","'14'","Engineering","Associate's degree","27","20","7","0","0","0","2","2","0","3","1","2","6","5","1","0","0","0","8","7","1","1","1","0","0","0","0","7","4","3","-2"
"198330","Coastal Carolina Community College","2019","First major","'14'","Engineering","Associate's degree","6","6","0","0","0","0","0","0","0","2","2","0","1","1","0","0","0","0","3","3","0","0","0","0","0","0","0","0","0","0","-2"
"198367","Craven Community College","2019","First major","'14'","Engineering","Associate's degree","7","6","1","0","0","0","0","0","0","0","0","0","1","1","0","0","0","0","4","3","1","0","0","0","1","1","0","1","1","0","-2"
"198419","Duke University","2019","First major","'14'","Engineering","Bachelor's degree","297","201","96","0","0","0","70","51","19","13","8","5","33","24","9","0","0","0","128","87","41","10","7","3","10","7","3","33","17","16","-2"
"198419","Duke University","2019","First major","'14'","Engineering","Master's degree","234","153","81","1","0","1","21","14","7","4","1","3","6","5","1","0","0","0","57","36","21","3","3","0","1","1","0","141","93","48","-2"
"198419","Duke University","2019","First major","'14'","Engineering","Doctor's degree - research/scholarship","74","53","21","0","0","0","9","8","1","1","0","1","5","3","2","0","0","0","33","23","10","1","1","0","1","1","0","24","17","7","-2"
"198419","Duke University","2019","Second major","'14'","Engineering","Bachelor's degree","22","21","1","0","0","0","7","7","0","1","1","0","3","3","0","0","0","0","11","10","1","0","0","0","0","0","0","0","0","0","-2"
"198455","Durham Technical Community College","2019","First major","'14'","Engineering","Associate's degree","11","10","1","0","0","0","0","0","0","0","0","0","2","1","1","0","0","0","8","8","0","1","1","0","0","0","0","0","0","0","-2"
"198464","East Carolina University","2019","First major","'14'","Engineering","Bachelor's degree","134","111","23","1","1","0","1","1","0","11","8","3","5","3","2","0","0","0","110","94","16","3","2","1","1","0","1","2","2","0","-2"
"198464","East Carolina University","2019","First major","'14'","Engineering","Master's degree","28","22","6","0","0","0","0","0","0","3","3","0","1","0","1","0","0","0","12","10","2","0","0","0","2","2","0","10","7","3","-2"
"198464","East Carolina University","2019","Second major","'14'","Engineering","Bachelor's degree","1","1","0","0","0","0","0","0","0","0","0","0","0","0","0","0","0","0","1","1","0","0","0","0","0","0","0","0","0","0","-2"
"198491","Edgecombe Community College","2019","First major","'14'","Engineering","Associate's degree","1","1","0","0","0","0","0","0","0","0","0","0","0","0","0","0","0","0","1","1","0","0","0","0","0","0","0","0","0","0","-2"
"198516","Elon University","2019","First major","'14'","Engineering","Bachelor's degree","9","7","2","0","0","0","1","1","0","0","0","0","1","1","0","0","0","0","6","4","2","0","0","0","0","0","0","1","1","0","-2"
"198534","Fayetteville Technical Community College","2019","First major","'14'","Engineering","Associate's degree","0","0","0","0","0","0","0","0","0","0","0","0","0","0","0","0","0","0","0","0","0","0","0","0","0","0","0","0","0","0","-2"
"198552","Forsyth Technical Community College","2019","First major","'14'","Engineering","Associate's degree","9","9","0","0","0","0","0","0","0","0","0","0","0","0","0","0","0","0","8","8","0","1","1","0","0","0","0","0","0","0","-2"
"198570","Gaston College","2019","First major","'14'","Engineering","Associate's degree","9","7","2","0","0","0","0","0","0","0","0","0","3","1","2","0","0","0","3","3","0","0","0","0","2","2","0","1","1","0","-2"
"198622","Guilford Technical Community College","2019","First major","'14'","Engineering","Associate's degree","7","7","0","0","0","0","0","0","0","1","1","0","1","1","0","0","0","0","4","4","0","1","1","0","0","0","0","0","0","0","-2"
"198640","Halifax Community College","2019","First major","'14'","Engineering","Associate's degree","0","0","0","0","0","0","0","0","0","0","0","0","0","0","0","0","0","0","0","0","0","0","0","0","0","0","0","0","0","0","-2"
"198668","Haywood Community College","2019","First major","'14'","Engineering","Associate's degree","3","3","0","0","0","0","0","0","0","0","0","0","0","0","0","0","0","0","3","3","0","0","0","0","0","0","0","0","0","0","-2"
"198695","High Point University","2019","First major","'14'","Engineering","Bachelor's degree","0","0","0","0","0","0","0","0","0","0","0","0","0","0","0","0","0","0","0","0","0","0","0","0","0","0","0","0","0","0","-2"
"198710","Isothermal Community College","2019","First major","'14'","Engineering","Associate's degree","0","0","0","0","0","0","0","0","0","0","0","0","0","0","0","0","0","0","0","0","0","0","0","0","0","0","0","0","0","0","-2"
"198756","Johnson C Smith University","2019","First major","'14'","Engineering","Bachelor's degree","3","2","1","0","0","0","0","0","0","2","1","1","1","1","0","0","0","0","0","0","0","0","0","0","0","0","0","0","0","0","-2"
"198774","Johnston Community College","2019","First major","'14'","Engineering","Associate's degree","18","17","1","0","0","0","0","0","0","1","1","0","3","3","0","0","0","0","12","11","1","1","1","0","1","1","0","0","0","0","-2"
"198817","Lenoir Community College","2019","First major","'14'","Engineering","Associate's degree","0","0","0","0","0","0","0","0","0","0","0","0","0","0","0","0","0","0","0","0","0","0","0","0","0","0","0","0","0","0","-2"
"198923","McDowell Technical Community College","2019","First major","'14'","Engineering","Associate's degree","2","1","1","0","0","0","0","0","0","0","0","0","0","0","0","0","0","0","2","1","1","0","0","0","0","0","0","0","0","0","-2"
"198987","Mitchell Community College","2019","First major","'14'","Engineering","Associate's degree","8","8","0","0","0","0","1","1","0","0","0","0","2","2","0","0","0","0","5","5","0","0","0","0","0","0","0","0","0","0","-2"
"199023","Montgomery Community College","2019","First major","'14'","Engineering","Associate's degree","0","0","0","0","0","0","0","0","0","0","0","0","0","0","0","0","0","0","0","0","0","0","0","0","0","0","0","0","0","0","-2"
"199087","Nash Community College","2019","First major","'14'","Engineering","Associate's degree","11","9","2","0","0","0","1","1","0","0","0","0","2","2","0","0","0","0","8","6","2","0","0","0","0","0","0","0","0","0","-2"
"199102","North Carolina A & T State University","2019","First major","'14'","Engineering","Bachelor's degree","211","150","61","0","0","0","8","7","1","127","79","48","9","8","1","0","0","0","25","19","6","4","3","1","10","6","4","28","28","0","-2"
"199102","North Carolina A & T State University","2019","First major","'14'","Engineering","Master's degree","61","40","21","0","0","0","1","1","0","33","20","13","1","0","1","0","0","0","4","4","0","0","0","0","2","1","1","20","14","6","-2"
"199102","North Carolina A & T State University","2019","First major","'14'","Engineering","Doctor's degree - research/scholarship","22","15","7","0","0","0","1","1","0","4","1","3","0","0","0","0","0","0","1","1","0","0","0","0","1","0","1","15","12","3","-2"
"199102","North Carolina A & T State University","2019","Second major","'14'","Engineering","Bachelor's degree","1","0","1","0","0","0","0","0","0","1","0","1","0","0","0","0","0","0","0","0","0","0","0","0","0","0","0","0","0","0","-2"
"199111","University of North Carolina at Asheville","2019","First major","'14'","Engineering","Bachelor's degree","31","28","3","0","0","0","0","0","0","0","0","0","2","2","0","0","0","0","27","25","2","1","0","1","1","1","0","0","0","0","-2"
"199120","University of North Carolina at Chapel Hill","2019","First major","'14'","Engineering","Bachelor's degree","77","43","34","0","0","0","15","7","8","1","1","0","5","2","3","1","0","1","47","28","19","5","4","1","3","1","2","0","0","0","-2"
"199120","University of North Carolina at Chapel Hill","2019","First major","'14'","Engineering","Master's degree","0","0","0","0","0","0","0","0","0","0","0","0","0","0","0","0","0","0","0","0","0","0","0","0","0","0","0","0","0","0","-2"
"199120","University of North Carolina at Chapel Hill","2019","First major","'14'","Engineering","Doctor's degree - research/scholarship","6","6","0","0","0","0","0","0","0","1","1","0","0","0","0","0","0","0","4","4","0","0","0","0","1","1","0","0","0","0","-2"
"199139","University of North Carolina at Charlotte","2019","First major","'14'","Engineering","Bachelor's degree","453","389","64","2","1","1","35","27","8","19","18","1","38","33","5","0","0","0","311","272","39","10","8","2","13","10","3","25","20","5","-2"
"199139","University of North Carolina at Charlotte","2019","First major","'14'","Engineering","Master's degree","132","105","27","0","0","0","3","2","1","0","0","0","1","0","1","0","0","0","36","32","4","1","1","0","1","0","1","90","70","20","-2"
"199139","University of North Carolina at Charlotte","2019","First major","'14'","Engineering","Doctor's degree - research/scholarship","32","30","2","0","0","0","0","0","0","1","1","0","0","0","0","0","0","0","6","5","1","0","0","0","0","0","0","25","24","1","-2"
"199193","North Carolina State University at Raleigh","2019","First major","'14'","Engineering","Bachelor's degree","1638","1114","524","4","4","0","122","81","41","59","34","25","73","46","27","2","1","1","1204","830","374","64","46","18","63","35","28","47","37","10","-2"
"199193","North Carolina State University at Raleigh","2019","First major","'14'","Engineering","Master's degree","772","569","203","0","0","0","42","24","18","8","4","4","11","10","1","0","0","0","239","176","63","6","5","1","8","6","2","458","344","114","-2"
"199193","North Carolina State University at Raleigh","2019","First major","'14'","Engineering","Doctor's degree - research/scholarship","195","137","58","0","0","0","13","10","3","4","1","3","5","4","1","0","0","0","56","42","14","5","3","2","3","3","0","109","74","35","-2"
"199193","North Carolina State University at Raleigh","2019","Second major","'14'","Engineering","Doctor's degree - research/scholarship","1","1","0","0","0","0","1","1","0","0","0","0","0","0","0","0","0","0","0","0","0","0","0","0","0","0","0","0","0","0","-2"
"199218","University of North Carolina Wilmington","2019","First major","'14'","Engineering","Bachelor's degree","0","0","0","0","0","0","0","0","0","0","0","0","0","0","0","0","0","0","0","0","0","0","0","0","0","0","0","0","0","0","-2"
"199333","Pitt Community College","2019","First major","'14'","Engineering","Associate's degree","10","10","0","0","0","0","1","1","0","0","0","0","0","0","0","0","0","0","9","9","0","0","0","0","0","0","0","0","0","0","-2"
"199449","Richmond Community College","2019","First major","'14'","Engineering","Associate's degree","1","1","0","0","0","0","0","0","0","0","0","0","0","0","0","0","0","0","0","0","0","0","0","0","1","1","0","0","0","0","-2"
"199582","Saint Augustine's University","2019","First major","'14'","Engineering","Bachelor's degree","2","1","1","0","0","0","0","0","0","2","1","1","0","0","0","0","0","0","0","0","0","0","0","0","0","0","0","0","0","0","-2"
"199634","Sandhills Community College","2019","First major","'14'","Engineering","Associate's degree","0","0","0","0","0","0","0","0","0","0","0","0","0","0","0","0","0","0","0","0","0","0","0","0","0","0","0","0","0","0","-2"
"199768","Surry Community College","2019","First major","'14'","Engineering","Associate's degree","0","0","0","0","0","0","0","0","0","0","0","0","0","0","0","0","0","0","0","0","0","0","0","0","0","0","0","0","0","0","-2"
"199786","Alamance Community College","2019","First major","'14'","Engineering","Associate's degree","1","1","0","0","0","0","0","0","0","0","0","0","0","0","0","0","0","0","1","1","0","0","0","0","0","0","0","0","0","0","-2"
"199847","Wake Forest University","2019","First major","'14'","Engineering","Bachelor's degree","0","0","0","0","0","0","0","0","0","0","0","0","0","0","0","0","0","0","0","0","0","0","0","0","0","0","0","0","0","0","-2"
"199847","Wake Forest University","2019","First major","'14'","Engineering","Master's degree","6","3","3","0","0","0","0","0","0","0","0","0","0","0","0","0","0","0","4","2","2","0","0","0","1","1","0","1","0","1","-2"
"199847","Wake Forest University","2019","First major","'14'","Engineering","Doctor's degree - research/scholarship","11","4","7","0","0","0","0","0","0","0","0","0","0","0","0","0","0","0","5","3","2","0","0","0","2","0","2","4","1","3","-2"
"199856","Wake Technical Community College","2019","First major","'14'","Engineering","Associate's degree","135","108","27","0","0","0","14","9","5","11","7","4","16","10","6","1","1","0","72","65","7","1","1","0","3","1","2","17","14","3","-2"
"199892","Wayne Community College","2019","First major","'14'","Engineering","Associate's degree","2","2","0","0","0","0","0","0","0","0","0","0","0","0","0","0","0","0","2","2","0","0","0","0","0","0","0","0","0","0","-2"
"199926","Wilkes Community College","2019","First major","'14'","Engineering","Associate's degree","3","3","0","0","0","0","0","0","0","0","0","0","0","0","0","0","0","0","3","3","0","0","0","0","0","0","0","0","0","0","-2"
"200004","Western Carolina University","2019","First major","'14'","Engineering","Bachelor's degree","47","45","2","0","0","0","2","2","0","0","0","0","1","0","1","0","0","0","36","36","0","3","3","0","1","1","0","4","3","1","-2"
"200013","Rasmussen University-North Dakota","2019","First major","'14'","Engineering","Associate's degree","6","4","2","0","0","0","0","0","0","0","0","0","0","0","0","0","0","0","6","4","2","0","0","0","0","0","0","0","0","0","-2"
"200086","Nueta Hidatsa Sahnish College","2019","First major","'14'","Engineering","Associate's degree","1","0","1","1","0","1","0","0","0","0","0","0","0","0","0","0","0","0","0","0","0","0","0","0","0","0","0","0","0","0","-2"
"200208","Cankdeska Cikana Community College","2019","First major","'14'","Engineering","Associate's degree","0","0","0","0","0","0","0","0","0","0","0","0","0","0","0","0","0","0","0","0","0","0","0","0","0","0","0","0","0","0","-2"
"200217","University of Mary","2019","First major","'14'","Engineering","Bachelor's degree","1","1","0","0","0","0","0","0","0","0","0","0","0","0","0","0","0","0","1","1","0","0","0","0","0","0","0","0","0","0","-2"
"200280","University of North Dakota","2019","First major","'14'","Engineering","Bachelor's degree","267","222","45","0","0","0","3","3","0","15","13","2","12","10","2","1","1","0","205","170","35","4","3","1","10","7","3","17","15","2","-2"
"200280","University of North Dakota","2019","First major","'14'","Engineering","Master's degree","54","43","11","2","1","1","2","2","0","2","2","0","0","0","0","0","0","0","19","15","4","1","1","0","1","1","0","27","21","6","-2"
"200280","University of North Dakota","2019","First major","'14'","Engineering","Doctor's degree - research/scholarship","7","6","1","0","0","0","0","0","0","1","1","0","0","0","0","0","0","0","0","0","0","0","0","0","0","0","0","6","5","1","-2"
"200332","North Dakota State University-Main Campus","2019","First major","'14'","Engineering","Bachelor's degree","378","346","32","2","2","0","3","3","0","7","7","0","8","7","1","1","1","0","338","308","30","7","7","0","7","7","0","5","4","1","-2"
"200332","North Dakota State University-Main Campus","2019","First major","'14'","Engineering","Master's degree","43","29","14","1","0","1","2","1","1","4","4","0","2","1","1","0","0","0","13","10","3","0","0","0","2","2","0","19","11","8","-2"
"200332","North Dakota State University-Main Campus","2019","First major","'14'","Engineering","Doctor's degree - research/scholarship","12","7","5","0","0","0","0","0","0","0","0","0","0","0","0","0","0","0","1","0","1","0","0","0","0","0","0","11","7","4","-2"
"200466","Sitting Bull College","2019","First major","'14'","Engineering","Associate's degree","0","0","0","0","0","0","0","0","0","0","0","0","0","0","0","0","0","0","0","0","0","0","0","0","0","0","0","0","0","0","-2"
"200554","United Tribes Technical College","2019","First major","'14'","Engineering","Associate's degree","3","2","1","3","2","1","0","0","0","0","0","0","0","0","0","0","0","0","0","0","0","0","0","0","0","0","0","0","0","0","-2"
"200572","Valley City State University","2019","First major","'14'","Engineering","Bachelor's degree","6","6","0","0","0","0","0","0","0","0","0","0","0","0","0","0","0","0","5","5","0","0","0","0","0","0","0","1","1","0","-2"
"200697","Air Force Institute of Technology-Graduate School of Engineering & Management","2019","First major","'14'","Engineering","Master's degree","155","134","21","0","0","0","4","4","0","3","3","0","12","11","1","0","0","0","111","97","14","8","5","3","13","11","2","4","3","1","-2"
"200697","Air Force Institute of Technology-Graduate School of Engineering & Management","2019","First major","'14'","Engineering","Doctor's degree - research/scholarship","32","29","3","0","0","0","0","0","0","0","0","0","1","1","0","0","0","0","25","23","2","2","1","1","4","4","0","0","0","0","-2"
"200800","University of Akron Main Campus","2019","First major","'14'","Engineering","Bachelor's degree","500","384","116","1","0","1","10","7","3","8","5","3","12","8","4","0","0","0","412","318","94","12","7","5","7","6","1","38","33","5","-2"
"200800","University of Akron Main Campus","2019","First major","'14'","Engineering","Master's degree","94","71","23","0","0","0","0","0","0","2","1","1","1","0","1","0","0","0","22","20","2","3","2","1","0","0","0","66","48","18","-2"
"200800","University of Akron Main Campus","2019","First major","'14'","Engineering","Doctor's degree - research/scholarship","70","56","14","0","0","0","3","2","1","0","0","0","1","1","0","0","0","0","10","8","2","0","0","0","1","1","0","55","44","11","-2"
"201195","Baldwin Wallace University","2019","First major","'14'","Engineering","Bachelor's degree","5","5","0","0","0","0","0","0","0","0","0","0","0","0","0","0","0","0","5","5","0","0","0","0","0","0","0","0","0","0","-2"
"201441","Bowling Green State University-Main Campus","2019","First major","'14'","Engineering","Bachelor's degree","90","80","10","0","0","0","0","0","0","4","4","0","3","2","1","0","0","0","72","64","8","4","3","1","2","2","0","5","5","0","-2"
"201441","Bowling Green State University-Main Campus","2019","First major","'14'","Engineering","Master's degree","23","15","8","0","0","0","0","0","0","0","0","0","0","0","0","0","0","0","5","4","1","0","0","0","0","0","0","18","11","7","-2"
"201645","Case Western Reserve University","2019","First major","'14'","Engineering","Bachelor's degree","371","251","120","0","0","0","60","38","22","10","8","2","19","15","4","0","0","0","211","142","69","20","11","9","6","2","4","45","35","10","-2"
"201645","Case Western Reserve University","2019","First major","'14'","Engineering","Master's degree","201","128","73","0","0","0","24","18","6","7","4","3","9","7","2","0","0","0","52","34","18","2","2","0","3","3","0","104","60","44","-2"
"201645","Case Western Reserve University","2019","First major","'14'","Engineering","Doctor's degree - research/scholarship","46","31","15","0","0","0","4","2","2","2","1","1","1","1","0","0","0","0","10","6","4","1","0","1","2","1","1","26","20","6","-2"
"201645","Case Western Reserve University","2019","Second major","'14'","Engineering","Bachelor's degree","50","43","7","0","0","0","6","6","0","2","2","0","5","5","0","0","0","0","29","22","7","4","4","0","1","1","0","3","3","0","-2"
"201654","Cedarville University","2019","First major","'14'","Engineering","Bachelor's degree","80","73","7","1","1","0","0","0","0","0","0","0","1","1","0","0","0","0","73","66","7","3","3","0","2","2","0","0","0","0","-2"
"201690","Central State University","2019","First major","'14'","Engineering","Bachelor's degree","9","6","3","0","0","0","0","0","0","9","6","3","0","0","0","0","0","0","0","0","0","0","0","0","0","0","0","0","0","0","-2"
"201885","University of Cincinnati-Main Campus","2019","First major","'14'","Engineering","Bachelor's degree","797","645","152","0","0","0","23","13","10","16","13","3","21","18","3","0","0","0","610","508","102","17","16","1","24","13","11","86","64","22","-2"
"201885","University of Cincinnati-Main Campus","2019","First major","'14'","Engineering","Master's degree","260","209","51","0","0","0","5","3","2","3","3","0","6","5","1","0","0","0","67","58","9","1","0","1","4","4","0","174","136","38","-2"
"201885","University of Cincinnati-Main Campus","2019","First major","'14'","Engineering","Doctor's degree - research/scholarship","50","39","11","0","0","0","0","0","0","0","0","0","0","0","0","0","0","0","11","10","1","0","0","0","2","2","0","37","27","10","-2"
"201928","Cincinnati State Technical and Community College","2019","First major","'14'","Engineering","Associate's degree","9","6","3","0","0","0","0","0","0","1","1","0","0","0","0","0","0","0","8","5","3","0","0","0","0","0","0","0","0","0","-2"
"201973","Clark State Community College","2019","First major","'14'","Engineering","Associate's degree","0","0","0","0","0","0","0","0","0","0","0","0","0","0","0","0","0","0","0","0","0","0","0","0","0","0","0","0","0","0","-2"
"202134","Cleveland State University","2019","First major","'14'","Engineering","Bachelor's degree","303","252","51","0","0","0","14","13","1","10","7","3","15","10","5","1","1","0","196","160","36","3","3","0","4","4","0","60","54","6","-2"
"202134","Cleveland State University","2019","First major","'14'","Engineering","Master's degree","126","98","28","0","0","0","3","2","1","0","0","0","2","1","1","0","0","0","45","33","12","1","1","0","3","3","0","72","58","14","-2"
"202134","Cleveland State University","2019","First major","'14'","Engineering","Doctor's degree - research/scholarship","8","6","2","0","0","0","0","0","0","0","0","0","0","0","0","0","0","0","3","3","0","0","0","0","0","0","0","5","3","2","-2"
"202480","University of Dayton","2019","First major","'14'","Engineering","Bachelor's degree","423","314","109","0","0","0","6","3","3","11","9","2","11","5","6","0","0","0","301","216","85","13","8","5","3","2","1","78","71","7","-2"
"202480","University of Dayton","2019","First major","'14'","Engineering","Master's degree","194","158","36","0","0","0","3","2","1","7","5","2","5","4","1","0","0","0","81","64","17","1","1","0","5","5","0","92","77","15","-2"
"202480","University of Dayton","2019","First major","'14'","Engineering","Doctor's degree - research/scholarship","29","26","3","0","0","0","3","2","1","1","1","0","2","2","0","0","0","0","9","7","2","0","0","0","2","2","0","12","12","0","-2"
"203331","Eastern Gateway Community College","2019","First major","'14'","Engineering","Associate's degree","3","1","2","0","0","0","0","0","0","0","0","0","0","0","0","0","0","0","3","1","2","0","0","0","0","0","0","0","0","0","-2"
"203368","John Carroll University","2019","First major","'14'","Engineering","Bachelor's degree","2","2","0","0","0","0","0","0","0","0","0","0","0","0","0","0","0","0","1","1","0","0","0","0","1","1","0","0","0","0","-2"
"203517","Kent State University at Kent","2019","First major","'14'","Engineering","Bachelor's degree","55","48","7","0","0","0","0","0","0","3","3","0","0","0","0","0","0","0","33","27","6","0","0","0","0","0","0","19","18","1","-2"
"203748","Lorain County Community College","2019","First major","'14'","Engineering","Associate's degree","6","5","1","0","0","0","0","0","0","0","0","0","0","0","0","0","0","0","5","4","1","0","0","0","0","0","0","1","1","0","-2"
"203845","Marietta College","2019","First major","'14'","Engineering","Bachelor's degree","73","63","10","0","0","0","1","1","0","1","1","0","0","0","0","0","0","0","38","34","4","2","2","0","2","2","0","29","23","6","-2"
"204024","Miami University-Oxford","2019","First major","'14'","Engineering","Bachelor's degree","295","220","75","2","2","0","8","6","2","10","5","5","9","5","4","1","1","0","207","158","49","9","4","5","1","1","0","48","38","10","-2"
"204024","Miami University-Oxford","2019","First major","'14'","Engineering","Master's degree","22","17","5","0","0","0","2","2","0","0","0","0","0","0","0","0","0","0","10","7","3","0","0","0","0","0","0","10","8","2","-2"
"204024","Miami University-Oxford","2019","Second major","'14'","Engineering","Bachelor's degree","15","11","4","0","0","0","2","2","0","0","0","0","0","0","0","0","0","0","9","6","3","0","0","0","0","0","0","4","3","1","-2"
"204185","University of Mount Union","2019","First major","'14'","Engineering","Bachelor's degree","23","21","2","0","0","0","0","0","0","1","1","0","0","0","0","0","0","0","21","19","2","0","0","0","1","1","0","0","0","0","-2"
"204194","Mount Vernon Nazarene University","2019","First major","'14'","Engineering","Bachelor's degree","3","2","1","0","0","0","0","0","0","0","0","0","0","0","0","0","0","0","3","2","1","0","0","0","0","0","0","0","0","0","-2"
"204255","Zane State College","2019","First major","'14'","Engineering","Associate's degree","20","18","2","0","0","0","0","0","0","0","0","0","0","0","0","0","0","0","19","17","2","0","0","0","1","1","0","0","0","0","-2"
"204264","Muskingum University","2019","First major","'14'","Engineering","Bachelor's degree","6","6","0","0","0","0","0","0","0","2","2","0","0","0","0","0","0","0","3","3","0","0","0","0","0","0","0","1","1","0","-2"
"204422","North Central State College","2019","First major","'14'","Engineering","Associate's degree","1","1","0","0","0","0","0","0","0","0","0","0","0","0","0","0","0","0","1","1","0","0","0","0","0","0","0","0","0","0","-2"
"204440","Northwest State Community College","2019","First major","'14'","Engineering","Associate's degree","0","0","0","0","0","0","0","0","0","0","0","0","0","0","0","0","0","0","0","0","0","0","0","0","0","0","0","0","0","0","-2"
"204468","Notre Dame College","2019","First major","'14'","Engineering","Bachelor's degree","0","0","0","0","0","0","0","0","0","0","0","0","0","0","0","0","0","0","0","0","0","0","0","0","0","0","0","0","0","0","-2"
"204468","Notre Dame College","2019","Second major","'14'","Engineering","Bachelor's degree","4","4","0","0","0","0","0","0","0","1","1","0","0","0","0","0","0","0","2","2","0","0","0","0","1","1","0","0","0","0","-2"
"204501","Oberlin College","2019","First major","'14'","Engineering","Bachelor's degree","2","2","0","0","0","0","0","0","0","1","1","0","0","0","0","0","0","0","1","1","0","0","0","0","0","0","0","0","0","0","-2"
"204501","Oberlin College","2019","Second major","'14'","Engineering","Bachelor's degree","1","1","0","0","0","0","1","1","0","0","0","0","0","0","0","0","0","0","0","0","0","0","0","0","0","0","0","0","0","0","-2"
"204617","Ohio Dominican University","2019","First major","'14'","Engineering","Bachelor's degree","3","2","1","0","0","0","0","0","0","1","1","0","0","0","0","0","0","0","0","0","0","0","0","0","2","1","1","0","0","0","-2"
"204635","Ohio Northern University","2019","First major","'14'","Engineering","Bachelor's degree","78","65","13","0","0","0","0","0","0","2","1","1","1","0","1","0","0","0","69","60","9","1","1","0","3","1","2","2","2","0","-2"
"204662","Ohio State University Agricultural Technical Institute","2019","First major","'14'","Engineering","Associate's degree","11","10","1","0","0","0","1","1","0","0","0","0","0","0","0","0","0","0","10","9","1","0","0","0","0","0","0","0","0","0","-2"
"204796","Ohio State University-Main Campus","2019","First major","'14'","Engineering","Bachelor's degree","1737","1333","404","2","2","0","147","116","31","38","27","11","50","41","9","0","0","0","1182","901","281","48","38","10","54","44","10","216","164","52","-2"
"204796","Ohio State University-Main Campus","2019","First major","'14'","Engineering","Master's degree","457","345","112","1","0","1","11","8","3","5","2","3","6","6","0","0","0","0","131","103","28","7","5","2","5","5","0","291","216","75","-2"
"204796","Ohio State University-Main Campus","2019","First major","'14'","Engineering","Doctor's degree - research/scholarship","165","128","37","1","1","0","3","2","1","2","0","2","4","3","1","0","0","0","47","37","10","1","1","0","2","1","1","105","83","22","-2"
"204796","Ohio State University-Main Campus","2019","Second major","'14'","Engineering","Bachelor's degree","1","1","0","0","0","0","0","0","0","0","0","0","0","0","0","0","0","0","1","1","0","0","0","0","0","0","0","0","0","0","-2"
"204802","Ohio University-Eastern Campus","2019","First major","'14'","Engineering","Bachelor's degree","0","0","0","0","0","0","0","0","0","0","0","0","0","0","0","0","0","0","0","0","0","0","0","0","0","0","0","0","0","0","-2"
"204820","Ohio University-Chillicothe Campus","2019","First major","'14'","Engineering","Bachelor's degree","0","0","0","0","0","0","0","0","0","0","0","0","0","0","0","0","0","0","0","0","0","0","0","0","0","0","0","0","0","0","-2"
"204839","Ohio University-Southern Campus","2019","First major","'14'","Engineering","Bachelor's degree","0","0","0","0","0","0","0","0","0","0","0","0","0","0","0","0","0","0","0","0","0","0","0","0","0","0","0","0","0","0","-2"
"204848","Ohio University-Lancaster Campus","2019","First major","'14'","Engineering","Bachelor's degree","0","0","0","0","0","0","0","0","0","0","0","0","0","0","0","0","0","0","0","0","0","0","0","0","0","0","0","0","0","0","-2"
"204857","Ohio University-Main Campus","2019","First major","'14'","Engineering","Bachelor's degree","230","181","49","0","0","0","0","0","0","4","3","1","5","2","3","0","0","0","196","156","40","5","3","2","3","3","0","17","14","3","-2"
"204857","Ohio University-Main Campus","2019","First major","'14'","Engineering","Master's degree","141","122","19","1","1","0","7","5","2","6","6","0","5","4","1","0","0","0","93","83","10","5","4","1","6","5","1","18","14","4","-2"
"204857","Ohio University-Main Campus","2019","First major","'14'","Engineering","Doctor's degree - research/scholarship","22","19","3","0","0","0","0","0","0","1","1","0","1","1","0","0","0","0","2","2","0","0","0","0","1","1","0","17","14","3","-2"
"204866","Ohio University-Zanesville Campus","2019","First major","'14'","Engineering","Bachelor's degree","0","0","0","0","0","0","0","0","0","0","0","0","0","0","0","0","0","0","0","0","0","0","0","0","0","0","0","0","0","0","-2"
"204936","Otterbein University","2019","First major","'14'","Engineering","Bachelor's degree","20","15","5","0","0","0","0","0","0","2","2","0","1","1","0","0","0","0","14","9","5","2","2","0","1","1","0","0","0","0","-2"
"204945","Owens Community College","2019","First major","'14'","Engineering","Associate's degree","5","5","0","0","0","0","0","0","0","0","0","0","0","0","0","0","0","0","4","4","0","0","0","0","0","0","0","1","1","0","-2"
"205203","University of Rio Grande","2019","First major","'14'","Engineering","Associate's degree","0","0","0","0","0","0","0","0","0","0","0","0","0","0","0","0","0","0","0","0","0","0","0","0","0","0","0","0","0","0","-2"
"205443","Shawnee State University","2019","First major","'14'","Engineering","Bachelor's degree","3","3","0","0","0","0","0","0","0","0","0","0","0","0","0","0","0","0","3","3","0","0","0","0","0","0","0","0","0","0","-2"
"205470","Sinclair Community College","2019","First major","'14'","Engineering","Associate's degree","68","58","10","1","0","1","2","1","1","6","3","3","5","5","0","0","0","0","44","39","5","0","0","0","7","7","0","3","3","0","-2"
"205841","Stark State College","2019","First major","'14'","Engineering","Associate's degree","23","22","1","0","0","0","2","2","0","0","0","0","0","0","0","0","0","0","20","19","1","1","1","0","0","0","0","0","0","0","-2"
"205957","Franciscan University of Steubenville","2019","First major","'14'","Engineering","Associate's degree","0","0","0","0","0","0","0","0","0","0","0","0","0","0","0","0","0","0","0","0","0","0","0","0","0","0","0","0","0","0","-2"
"206084","University of Toledo","2019","First major","'14'","Engineering","Bachelor's degree","446","378","68","2","2","0","11","6","5","17","14","3","19","17","2","0","0","0","351","299","52","9","7","2","4","4","0","33","29","4","-2"
"206084","University of Toledo","2019","First major","'14'","Engineering","Master's degree","105","87","18","0","0","0","3","2","1","0","0","0","0","0","0","0","0","0","17","14","3","1","1","0","0","0","0","84","70","14","-2"
"206084","University of Toledo","2019","First major","'14'","Engineering","Doctor's degree - research/scholarship","22","17","5","0","0","0","1","0","1","1","1","0","0","0","0","0","0","0","4","3","1","0","0","0","0","0","0","16","13","3","-2"
"206437","Walsh University","2019","First major","'14'","Engineering","Bachelor's degree","0","0","0","0","0","0","0","0","0","0","0","0","0","0","0","0","0","0","0","0","0","0","0","0","0","0","0","0","0","0","-2"
"206446","Washington State Community College","2019","First major","'14'","Engineering","Associate's degree","0","0","0","0","0","0","0","0","0","0","0","0","0","0","0","0","0","0","0","0","0","0","0","0","0","0","0","0","0","0","-2"
"206491","Wilberforce University","2019","First major","'14'","Engineering","Bachelor's degree","0","0","0","0","0","0","0","0","0","0","0","0","0","0","0","0","0","0","0","0","0","0","0","0","0","0","0","0","0","0","-2"
"206604","Wright State University-Main Campus","2019","First major","'14'","Engineering","Bachelor's degree","315","258","57","0","0","0","19","14","5","9","6","3","10","8","2","0","0","0","219","182","37","11","8","3","6","6","0","41","34","7","-2"
"206604","Wright State University-Main Campus","2019","First major","'14'","Engineering","Master's degree","174","131","43","0","0","0","5","5","0","3","1","2","3","2","1","0","0","0","71","51","20","3","3","0","1","1","0","88","68","20","-2"
"206604","Wright State University-Main Campus","2019","First major","'14'","Engineering","Doctor's degree - research/scholarship","18","16","2","0","0","0","3","1","2","0","0","0","0","0","0","0","0","0","3","3","0","0","0","0","0","0","0","12","12","0","-2"
"206613","Wright State University-Lake Campus","2019","First major","'14'","Engineering","Bachelor's degree","24","22","2","0","0","0","0","0","0","0","0","0","0","0","0","0","0","0","24","22","2","0","0","0","0","0","0","0","0","0","-2"
"206622","Xavier University","2019","First major","'14'","Engineering","Bachelor's degree","7","6","1","0","0","0","0","0","0","0","0","0","2","2","0","0","0","0","5","4","1","0","0","0","0","0","0","0","0","0","-2"
"206695","Youngstown State University","2019","First major","'14'","Engineering","Bachelor's degree","186","161","25","1","1","0","1","1","0","4","3","1","6","6","0","0","0","0","126","105","21","5","4","1","9","7","2","34","34","0","-2"
"206695","Youngstown State University","2019","First major","'14'","Engineering","Master's degree","21","19","2","0","0","0","1","1","0","0","0","0","1","1","0","0","0","0","8","6","2","0","0","0","0","0","0","11","11","0","-2"
"206914","Cameron University","2019","First major","'14'","Engineering","Associate's degree","7","7","0","0","0","0","0","0","0","1","1","0","0","0","0","0","0","0","3","3","0","1","1","0","2","2","0","0","0","0","-2"
"206923","Carl Albert State College","2019","First major","'14'","Engineering","Associate's degree","4","3","1","0","0","0","0","0","0","0","0","0","0","0","0","0","0","0","3","2","1","0","0","0","0","0","0","1","1","0","-2"
"206941","University of Central Oklahoma","2019","First major","'14'","Engineering","Bachelor's degree","73","66","7","0","0","0","7","7","0","2","1","1","1","1","0","0","0","0","33","30","3","3","2","1","12","12","0","15","13","2","-2"
"206941","University of Central Oklahoma","2019","First major","'14'","Engineering","Master's degree","7","4","3","0","0","0","1","0","1","1","1","0","0","0","0","0","0","0","3","1","2","0","0","0","0","0","0","2","2","0","-2"
"207263","Northeastern State University","2019","First major","'14'","Engineering","Bachelor's degree","1","1","0","0","0","0","0","0","0","0","0","0","0","0","0","0","0","0","1","1","0","0","0","0","0","0","0","0","0","0","-2"
"207290","Northeastern Oklahoma A&M College","2019","First major","'14'","Engineering","Associate's degree","4","2","2","1","1","0","0","0","0","0","0","0","1","0","1","0","0","0","2","1","1","0","0","0","0","0","0","0","0","0","-2"
"207324","Oklahoma Christian University","2019","First major","'14'","Engineering","Bachelor's degree","37","33","4","0","0","0","0","0","0","2","2","0","1","1","0","0","0","0","29","26","3","5","4","1","0","0","0","0","0","0","-2"
"207324","Oklahoma Christian University","2019","First major","'14'","Engineering","Master's degree","101","83","18","1","1","0","54","45","9","5","5","0","4","4","0","0","0","0","32","24","8","4","4","0","1","0","1","0","0","0","-2"
"207388","Oklahoma State University-Main Campus","2019","First major","'14'","Engineering","Bachelor's degree","620","483","137","22","12","10","22","19","3","13","9","4","46","39","7","0","0","0","427","335","92","45","30","15","1","1","0","44","38","6","-2"
"207388","Oklahoma State University-Main Campus","2019","First major","'14'","Engineering","Master's degree","117","86","31","1","0","1","2","2","0","3","2","1","6","4","2","1","1","0","57","44","13","2","1","1","3","2","1","42","30","12","-2"
"207388","Oklahoma State University-Main Campus","2019","First major","'14'","Engineering","Doctor's degree - research/scholarship","38","31","7","0","0","0","1","0","1","0","0","0","0","0","0","0","0","0","6","6","0","1","0","1","0","0","0","30","25","5","-2"
"207449","Oklahoma City Community College","2019","First major","'14'","Engineering","Associate's degree","39","35","4","0","0","0","3","2","1","1","1","0","1","1","0","0","0","0","24","22","2","1","1","0","4","3","1","5","5","0","-2"
"207458","Oklahoma City University","2019","First major","'14'","Engineering","Bachelor's degree","5","2","3","0","0","0","0","0","0","0","0","0","2","1","1","0","0","0","2","1","1","0","0","0","0","0","0","1","0","1","-2"
"207500","University of Oklahoma-Norman Campus","2019","First major","'14'","Engineering","Bachelor's degree","735","541","194","15","9","6","57","38","19","31","23","8","60","45","15","1","0","1","433","329","104","40","26","14","20","14","6","78","57","21","-2"
"207500","University of Oklahoma-Norman Campus","2019","First major","'14'","Engineering","Master's degree","127","92","35","3","1","2","4","3","1","2","1","1","10","8","2","0","0","0","45","36","9","4","0","4","4","3","1","55","40","15","-2"
"207500","University of Oklahoma-Norman Campus","2019","First major","'14'","Engineering","Doctor's degree - research/scholarship","49","40","9","0","0","0","0","0","0","0","0","0","0","0","0","0","0","0","9","9","0","0","0","0","3","3","0","37","28","9","-2"
"207582","Oral Roberts University","2019","First major","'14'","Engineering","Bachelor's degree","26","23","3","1","1","0","0","0","0","2","2","0","3","3","0","0","0","0","12","9","3","2","2","0","2","2","0","4","4","0","-2"
"207670","Rose State College","2019","First major","'14'","Engineering","Associate's degree","21","17","4","0","0","0","2","2","0","1","1","0","2","2","0","0","0","0","15","11","4","0","0","0","1","1","0","0","0","0","-2"
"207740","Seminole State College","2019","First major","'14'","Engineering","Associate's degree","5","3","2","1","1","0","1","1","0","0","0","0","0","0","0","0","0","0","3","1","2","0","0","0","0","0","0","0","0","0","-2"
"207847","Southeastern Oklahoma State University","2019","First major","'14'","Engineering","Master's degree","62","44","18","1","0","1","3","1","2","7","6","1","3","2","1","0","0","0","46","33","13","1","1","0","0","0","0","1","1","0","-2"
"207865","Southwestern Oklahoma State University","2019","First major","'14'","Engineering","Bachelor's degree","3","3","0","0","0","0","0","0","0","0","0","0","0","0","0","0","0","0","2","2","0","0","0","0","0","0","0","1","1","0","-2"
"207935","Tulsa Community College","2019","First major","'14'","Engineering","Associate's degree","98","87","11","4","4","0","6","5","1","3","1","2","11","10","1","0","0","0","51","46","5","12","10","2","2","2","0","9","9","0","-2"
"207971","University of Tulsa","2019","First major","'14'","Engineering","Bachelor's degree","195","151","44","5","3","2","14","9","5","7","5","2","9","7","2","0","0","0","74","53","21","0","0","0","5","3","2","81","71","10","-2"
"207971","University of Tulsa","2019","First major","'14'","Engineering","Master's degree","33","25","8","0","0","0","0","0","0","0","0","0","3","2","1","0","0","0","8","5","3","1","1","0","2","1","1","19","16","3","-2"
"207971","University of Tulsa","2019","First major","'14'","Engineering","Doctor's degree - research/scholarship","20","15","5","0","0","0","0","0","0","0","0","0","0","0","0","0","0","0","2","2","0","0","0","0","1","1","0","17","12","5","-2"
"208390","Chemeketa Community College","2019","First major","'14'","Engineering","Associate's degree","11","10","1","0","0","0","0","0","0","0","0","0","3","3","0","0","0","0","6","6","0","2","1","1","0","0","0","0","0","0","-2"
"208406","Clackamas Community College","2019","First major","'14'","Engineering","Associate's degree","32","23","9","0","0","0","3","2","1","0","0","0","3","3","0","0","0","0","21","15","6","2","2","0","2","1","1","1","0","1","-2"
"208822","George Fox University","2019","First major","'14'","Engineering","Bachelor's degree","50","41","9","0","0","0","2","1","1","0","0","0","3","3","0","0","0","0","41","33","8","4","4","0","0","0","0","0","0","0","-2"
"209065","Linfield University-McMinnville Campus","2019","First major","'14'","Engineering","Bachelor's degree","6","6","0","0","0","0","0","0","0","0","0","0","1","1","0","0","0","0","1","1","0","1","1","0","2","2","0","1","1","0","-2"
"209074","Linn-Benton Community College","2019","First major","'14'","Engineering","Associate's degree","9","8","1","0","0","0","0","0","0","0","0","0","2","2","0","0","0","0","6","5","1","1","1","0","0","0","0","0","0","0","-2"
"209250","Mt Hood Community College","2019","First major","'14'","Engineering","Associate's degree","14","9","5","0","0","0","0","0","0","0","0","0","0","0","0","0","0","0","14","9","5","0","0","0","0","0","0","0","0","0","-2"
"209490","Oregon Health & Science University","2019","First major","'14'","Engineering","Master's degree","7","4","3","0","0","0","1","0","1","0","0","0","1","1","0","0","0","0","4","3","1","1","0","1","0","0","0","0","0","0","-2"
"209490","Oregon Health & Science University","2019","First major","'14'","Engineering","Doctor's degree - research/scholarship","9","5","4","0","0","0","2","1","1","0","0","0","1","0","1","0","0","0","3","2","1","0","0","0","0","0","0","3","2","1","-2"
"209506","Oregon Institute of Technology","2019","First major","'14'","Engineering","Bachelor's degree","142","133","9","0","0","0","7","6","1","5","4","1","15","14","1","0","0","0","99","93","6","3","3","0","7","7","0","6","6","0","-2"
"209506","Oregon Institute of Technology","2019","First major","'14'","Engineering","Master's degree","7","5","2","0","0","0","0","0","0","0","0","0","1","1","0","0","0","0","1","0","1","0","0","0","2","1","1","3","3","0","-2"
"209506","Oregon Institute of Technology","2019","Second major","'14'","Engineering","Bachelor's degree","2","2","0","0","0","0","0","0","0","0","0","0","1","1","0","0","0","0","1","1","0","0","0","0","0","0","0","0","0","0","-2"
"209542","Oregon State University","2019","First major","'14'","Engineering","Bachelor's degree","984","783","201","2","2","0","68","47","21","8","6","2","60","41","19","2","1","1","640","517","123","62","51","11","25","20","5","117","98","19","209542"
"209542","Oregon State University","2019","First major","'14'","Engineering","Master's degree","228","184","44","0","0","0","13","11","2","2","2","0","5","2","3","0","0","0","93","75","18","9","7","2","4","2","2","102","85","17","209542"
"209542","Oregon State University","2019","First major","'14'","Engineering","Doctor's degree - research/scholarship","75","59","16","0","0","0","1","1","0","1","0","1","1","1","0","0","0","0","25","18","7","0","0","0","2","1","1","45","38","7","209542"
"209542","Oregon State University","2019","Second major","'14'","Engineering","Bachelor's degree","15","14","1","0","0","0","1","1","0","0","0","0","2","1","1","0","0","0","6","6","0","4","4","0","0","0","0","2","2","0","209542"
"209542","Oregon State University","2019","Second major","'14'","Engineering","Master's degree","1","1","0","0","0","0","0","0","0","0","0","0","0","0","0","0","0","0","1","1","0","0","0","0","0","0","0","0","0","0","209542"
"209542","Oregon State University","2019","Second major","'14'","Engineering","Doctor's degree - research/scholarship","4","3","1","0","0","0","0","0","0","0","0","0","0","0","0","0","0","0","2","1","1","0","0","0","0","0","0","2","2","0","209542"
"209746","Portland Community College","2019","First major","'14'","Engineering","Associate's degree","12","12","0","0","0","0","2","2","0","0","0","0","1","1","0","0","0","0","9","9","0","0","0","0","0","0","0","0","0","0","-2"
"209807","Portland State University","2019","First major","'14'","Engineering","Bachelor's degree","265","216","49","1","0","1","27","20","7","4","3","1","18","12","6","2","2","0","138","118","20","12","6","6","11","10","1","52","45","7","-2"
"209807","Portland State University","2019","First major","'14'","Engineering","Master's degree","193","141","52","0","0","0","10","5","5","4","4","0","7","7","0","0","0","0","55","49","6","7","6","1","0","0","0","110","70","40","-2"
"209807","Portland State University","2019","First major","'14'","Engineering","Doctor's degree - research/scholarship","20","14","6","0","0","0","3","3","0","1","0","1","0","0","0","0","0","0","2","2","0","0","0","0","1","1","0","13","8","5","-2"
"209825","University of Portland","2019","First major","'14'","Engineering","Bachelor's degree","119","83","36","0","0","0","16","11","5","1","1","0","8","5","3","2","1","1","70","48","22","13","9","4","5","4","1","4","4","0","-2"
"209825","University of Portland","2019","First major","'14'","Engineering","Master's degree","10","6","4","0","0","0","0","0","0","1","0","1","0","0","0","0","0","0","7","5","2","0","0","0","0","0","0","2","1","1","-2"
"209940","Rogue Community College","2019","First major","'14'","Engineering","Associate's degree","4","4","0","0","0","0","0","0","0","0","0","0","0","0","0","0","0","0","4","4","0","0","0","0","0","0","0","0","0","0","-2"
"210155","Southwestern Oregon Community College","2019","First major","'14'","Engineering","Associate's degree","0","0","0","0","0","0","0","0","0","0","0","0","0","0","0","0","0","0","0","0","0","0","0","0","0","0","0","0","0","0","-2"
"210234","Treasure Valley Community College","2019","First major","'14'","Engineering","Associate's degree","0","0","0","0","0","0","0","0","0","0","0","0","0","0","0","0","0","0","0","0","0","0","0","0","0","0","0","0","0","0","-2"
"210605","Community College of Allegheny County","2019","First major","'14'","Engineering","Associate's degree","17","15","2","0","0","0","0","0","0","1","1","0","1","1","0","0","0","0","11","10","1","0","0","0","4","3","1","0","0","0","-2"
"210669","Allegheny College","2019","First major","'14'","Engineering","Bachelor's degree","2","2","0","0","0","0","0","0","0","1","1","0","1","1","0","0","0","0","0","0","0","0","0","0","0","0","0","0","0","0","-2"
"211079","Community College of Beaver County","2019","First major","'14'","Engineering","Associate's degree","4","2","2","0","0","0","0","0","0","2","1","1","0","0","0","0","0","0","2","1","1","0","0","0","0","0","0","0","0","0","-2"
"211158","Bloomsburg University of Pennsylvania","2019","First major","'14'","Engineering","Bachelor's degree","7","6","1","0","0","0","0","0","0","0","0","0","0","0","0","0","0","0","6","5","1","1","1","0","0","0","0","0","0","0","-2"
"211291","Bucknell University","2019","First major","'14'","Engineering","Bachelor's degree","154","103","51","0","0","0","5","5","0","5","3","2","12","10","2","0","0","0","100","66","34","9","4","5","0","0","0","23","15","8","-2"
"211291","Bucknell University","2019","First major","'14'","Engineering","Master's degree","5","5","0","0","0","0","0","0","0","0","0","0","0","0","0","0","0","0","3","3","0","0","0","0","0","0","0","2","2","0","-2"
"211307","Bucks County Community College","2019","First major","'14'","Engineering","Associate's degree","11","8","3","0","0","0","0","0","0","0","0","0","2","2","0","0","0","0","6","4","2","1","0","1","2","2","0","0","0","0","-2"
"211343","Butler County Community College","2019","First major","'14'","Engineering","Associate's degree","4","4","0","0","0","0","0","0","0","0","0","0","0","0","0","0","0","0","4","4","0","0","0","0","0","0","0","0","0","0","-2"
"211361","California University of Pennsylvania","2019","First major","'14'","Engineering","Bachelor's degree","19","18","1","0","0","0","0","0","0","1","1","0","0","0","0","0","0","0","18","17","1","0","0","0","0","0","0","0","0","0","-2"
"211440","Carnegie Mellon University","2019","First major","'14'","Engineering","Bachelor's degree","435","275","160","0","0","0","121","74","47","32","23","9","46","30","16","0","0","0","118","79","39","17","14","3","18","7","11","83","48","35","-2"
"211440","Carnegie Mellon University","2019","First major","'14'","Engineering","Master's degree","917","644","273","0","0","0","91","61","30","15","11","4","21","16","5","0","0","0","85","67","18","11","8","3","42","33","9","652","448","204","-2"
"211440","Carnegie Mellon University","2019","First major","'14'","Engineering","Doctor's degree - research/scholarship","144","108","36","0","0","0","11","8","3","1","1","0","1","1","0","0","0","0","32","22","10","2","0","2","7","6","1","90","70","20","-2"
"211440","Carnegie Mellon University","2019","Second major","'14'","Engineering","Bachelor's degree","99","48","51","0","0","0","31","15","16","5","1","4","11","8","3","0","0","0","30","14","16","2","1","1","6","3","3","14","6","8","-2"
"211927","Delaware County Community College","2019","First major","'14'","Engineering","Associate's degree","37","26","11","0","0","0","7","6","1","3","2","1","0","0","0","0","0","0","21","13","8","1","1","0","1","1","0","4","3","1","-2"
"212054","Drexel University","2019","First major","'14'","Engineering","Bachelor's degree","722","547","175","0","0","0","131","90","41","22","14","8","40","31","9","6","4","2","398","320","78","15","11","4","10","8","2","100","69","31","-2"
"212054","Drexel University","2019","First major","'14'","Engineering","Master's degree","255","162","93","0","0","0","33","16","17","7","5","2","12","6","6","0","0","0","130","90","40","2","0","2","8","6","2","63","39","24","-2"
"212054","Drexel University","2019","First major","'14'","Engineering","Doctor's degree - research/scholarship","61","44","17","0","0","0","8","5","3","1","1","0","1","1","0","0","0","0","22","15","7","1","1","0","2","2","0","26","19","7","-2"
"212054","Drexel University","2019","Second major","'14'","Engineering","Bachelor's degree","27","21","6","0","0","0","1","1","0","2","1","1","0","0","0","0","0","0","15","11","4","2","1","1","2","2","0","5","5","0","-2"
"212054","Drexel University","2019","Second major","'14'","Engineering","Master's degree","1","1","0","0","0","0","0","0","0","0","0","0","1","1","0","0","0","0","0","0","0","0","0","0","0","0","0","0","0","0","-2"
"212106","Duquesne University","2019","First major","'14'","Engineering","Bachelor's degree","16","9","7","0","0","0","0","0","0","1","0","1","0","0","0","0","0","0","15","9","6","0","0","0","0","0","0","0","0","0","-2"
"212106","Duquesne University","2019","First major","'14'","Engineering","Master's degree","7","4","3","0","0","0","0","0","0","0","0","0","0","0","0","0","0","0","7","4","3","0","0","0","0","0","0","0","0","0","-2"
"212197","Elizabethtown College","2019","First major","'14'","Engineering","Bachelor's degree","30","22","8","0","0","0","2","2","0","0","0","0","0","0","0","0","0","0","26","18","8","0","0","0","0","0","0","2","2","0","-2"
"212601","Gannon University","2019","First major","'14'","Engineering","Bachelor's degree","72","56","16","0","0","0","0","0","0","1","1","0","1","1","0","0","0","0","46","32","14","0","0","0","1","0","1","23","22","1","-2"
"212601","Gannon University","2019","First major","'14'","Engineering","Master's degree","26","25","1","0","0","0","0","0","0","0","0","0","0","0","0","0","0","0","4","4","0","0","0","0","0","0","0","22","21","1","-2"
"212656","Geneva College","2019","First major","'14'","Engineering","Associate's degree","1","1","0","0","0","0","0","0","0","0","0","0","0","0","0","0","0","0","1","1","0","0","0","0","0","0","0","0","0","0","-2"
"212656","Geneva College","2019","First major","'14'","Engineering","Bachelor's degree","66","56","10","0","0","0","0","0","0","1","1","0","2","2","0","0","0","0","59","49","10","2","2","0","1","1","0","1","1","0","-2"
"212805","Grove City College","2019","First major","'14'","Engineering","Bachelor's degree","54","45","9","0","0","0","0","0","0","0","0","0","0","0","0","0","0","0","54","45","9","0","0","0","0","0","0","0","0","0","-2"
"212878","Harrisburg Area Community College","2019","First major","'14'","Engineering","Associate's degree","46","40","6","0","0","0","2","2","0","0","0","0","0","0","0","0","0","0","40","34","6","1","1","0","2","2","0","1","1","0","-2"
"213251","Juniata College","2019","First major","'14'","Engineering","Bachelor's degree","2","1","1","0","0","0","0","0","0","1","1","0","0","0","0","0","0","0","1","0","1","0","0","0","0","0","0","0","0","0","-2"
"213321","King's College","2019","First major","'14'","Engineering","Bachelor's degree","1","1","0","0","0","0","0","0","0","0","0","0","0","0","0","0","0","0","1","1","0","0","0","0","0","0","0","0","0","0","-2"
"213385","Lafayette College","2019","First major","'14'","Engineering","Bachelor's degree","143","89","54","0","0","0","4","2","2","10","6","4","4","2","2","0","0","0","90","49","41","3","1","2","10","10","0","22","19","3","-2"
"213385","Lafayette College","2019","Second major","'14'","Engineering","Bachelor's degree","3","3","0","0","0","0","0","0","0","0","0","0","0","0","0","0","0","0","3","3","0","0","0","0","0","0","0","0","0","0","-2"
"213525","Lehigh Carbon Community College","2019","First major","'14'","Engineering","Associate's degree","6","5","1","0","0","0","1","1","0","0","0","0","1","1","0","0","0","0","4","3","1","0","0","0","0","0","0","0","0","0","-2"
"213543","Lehigh University","2019","First major","'14'","Engineering","Bachelor's degree","363","239","124","0","0","0","38","20","18","7","5","2","32","21","11","0","0","0","233","156","77","4","3","1","16","14","2","33","20","13","-2"
"213543","Lehigh University","2019","First major","'14'","Engineering","Master's degree","144","113","31","0","0","0","3","2","1","1","1","0","5","3","2","1","0","1","55","44","11","1","0","1","0","0","0","78","63","15","-2"
"213543","Lehigh University","2019","First major","'14'","Engineering","Doctor's degree - research/scholarship","51","46","5","0","0","0","0","0","0","1","1","0","0","0","0","0","0","0","11","9","2","1","1","0","1","1","0","37","34","3","-2"
"213598","Lincoln University","2019","First major","'14'","Engineering","Bachelor's degree","2","1","1","0","0","0","0","0","0","2","1","1","0","0","0","0","0","0","0","0","0","0","0","0","0","0","0","0","0","0","-2"
"213659","Luzerne County Community College","2019","First major","'14'","Engineering","Associate's degree","1","0","1","0","0","0","0","0","0","0","0","0","0","0","0","0","0","0","0","0","0","0","0","0","1","0","1","0","0","0","-2"
"213996","Messiah University","2019","First major","'14'","Engineering","Bachelor's degree","50","43","7","0","0","0","1","1","0","1","1","0","1","1","0","0","0","0","44","37","7","0","0","0","0","0","0","3","3","0","-2"
"214111","Montgomery County Community College","2019","First major","'14'","Engineering","Associate's degree","20","20","0","0","0","0","5","5","0","0","0","0","1","1","0","1","1","0","8","8","0","2","2","0","1","1","0","2","2","0","-2"
"214379","Northampton County Area Community College","2019","First major","'14'","Engineering","Associate's degree","9","9","0","0","0","0","0","0","0","0","0","0","4","4","0","0","0","0","4","4","0","1","1","0","0","0","0","0","0","0","-2"
"214591","Pennsylvania State University-Penn State Erie-Behrend College","2019","First major","'14'","Engineering","Associate's degree","0","0","0","0","0","0","0","0","0","0","0","0","0","0","0","0","0","0","0","0","0","0","0","0","0","0","0","0","0","0","-2"
"214591","Pennsylvania State University-Penn State Erie-Behrend College","2019","First major","'14'","Engineering","Bachelor's degree","220","185","35","0","0","0","6","4","2","2","2","0","5","4","1","0","0","0","190","161","29","9","7","2","0","0","0","8","7","1","-2"
"214591","Pennsylvania State University-Penn State Erie-Behrend College","2019","First major","'14'","Engineering","Master's degree","4","3","1","0","0","0","0","0","0","0","0","0","0","0","0","0","0","0","4","3","1","0","0","0","0","0","0","0","0","0","-2"
"214607","Pennsylvania State University-Penn State Great Valley","2019","First major","'14'","Engineering","Master's degree","10","5","5","0","0","0","0","0","0","0","0","0","0","0","0","0","0","0","7","3","4","0","0","0","0","0","0","3","2","1","-2"
"214616","Pennsylvania State University-College of Medicine","2019","First major","'14'","Engineering","Doctor's degree - research/scholarship","0","0","0","0","0","0","0","0","0","0","0","0","0","0","0","0","0","0","0","0","0","0","0","0","0","0","0","0","0","0","-2"
"214625","Pennsylvania State University-Penn State New Kensington","2019","First major","'14'","Engineering","Bachelor's degree","1","1","0","0","0","0","0","0","0","0","0","0","0","0","0","0","0","0","1","1","0","0","0","0","0","0","0","0","0","0","-2"
"214643","Pennsylvania State University-Penn State Wilkes-Barre","2019","First major","'14'","Engineering","Bachelor's degree","19","19","0","0","0","0","2","2","0","0","0","0","0","0","0","0","0","0","17","17","0","0","0","0","0","0","0","0","0","0","-2"
"214670","Pennsylvania State University-Penn State Lehigh Valley","2019","First major","'14'","Engineering","Bachelor's degree","0","0","0","0","0","0","0","0","0","0","0","0","0","0","0","0","0","0","0","0","0","0","0","0","0","0","0","0","0","0","-2"
"214689","Pennsylvania State University-Penn State Altoona","2019","First major","'14'","Engineering","Bachelor's degree","5","5","0","0","0","0","0","0","0","0","0","0","1","1","0","0","0","0","3","3","0","0","0","0","1","1","0","0","0","0","-2"
"214704","Pennsylvania State University-Penn State Berks","2019","First major","'14'","Engineering","Bachelor's degree","30","29","1","0","0","0","1","1","0","0","0","0","1","1","0","0","0","0","27","26","1","0","0","0","1","1","0","0","0","0","-2"
"214713","Pennsylvania State University-Penn State Harrisburg","2019","First major","'14'","Engineering","Bachelor's degree","230","205","25","1","1","0","16","9","7","6","6","0","14","12","2","1","1","0","171","157","14","2","2","0","10","9","1","9","8","1","-2"
"214713","Pennsylvania State University-Penn State Harrisburg","2019","First major","'14'","Engineering","Master's degree","13","13","0","0","0","0","2","2","0","0","0","0","0","0","0","0","0","0","4","4","0","1","1","0","0","0","0","6","6","0","-2"
"214731","Pennsylvania State University-Penn State Brandywine","2019","First major","'14'","Engineering","Bachelor's degree","5","4","1","0","0","0","0","0","0","0","0","0","0","0","0","0","0","0","5","4","1","0","0","0","0","0","0","0","0","0","-2"
"214740","Pennsylvania State University-Penn State DuBois","2019","First major","'14'","Engineering","Bachelor's degree","4","4","0","0","0","0","0","0","0","0","0","0","0","0","0","0","0","0","4","4","0","0","0","0","0","0","0","0","0","0","-2"
"214759","Pennsylvania State University-Penn State Fayette- Eberly","2019","First major","'14'","Engineering","Associate's degree","0","0","0","0","0","0","0","0","0","0","0","0","0","0","0","0","0","0","0","0","0","0","0","0","0","0","0","0","0","0","-2"
"214768","Pennsylvania State University-Penn State Hazleton","2019","First major","'14'","Engineering","Bachelor's degree","8","6","2","0","0","0","0","0","0","0","0","0","3","1","2","0","0","0","5","5","0","0","0","0","0","0","0","0","0","0","-2"
"214777","Pennsylvania State University-Main Campus","2019","First major","'14'","Engineering","Bachelor's degree","1881","1457","424","0","0","0","125","97","28","24","19","5","78","59","19","1","1","0","1199","935","264","58","43","15","43","25","18","353","278","75","-2"
"214777","Pennsylvania State University-Main Campus","2019","First major","'14'","Engineering","Master's degree","316","237","79","0","0","0","11","6","5","4","3","1","7","4","3","0","0","0","100","68","32","8","8","0","0","0","0","186","148","38","-2"
"214777","Pennsylvania State University-Main Campus","2019","First major","'14'","Engineering","Doctor's degree - research/scholarship","152","116","36","0","0","0","6","3","3","0","0","0","4","3","1","0","0","0","38","28","10","1","0","1","3","2","1","100","80","20","-2"
"214801","Pennsylvania State University-Penn State Abington","2019","First major","'14'","Engineering","Bachelor's degree","9","9","0","0","0","0","0","0","0","0","0","0","0","0","0","0","0","0","9","9","0","0","0","0","0","0","0","0","0","0","-2"
"214829","Pennsylvania State University-Penn State York","2019","First major","'14'","Engineering","Bachelor's degree","2","2","0","0","0","0","0","0","0","0","0","0","0","0","0","0","0","0","2","2","0","0","0","0","0","0","0","0","0","0","-2"
"215062","University of Pennsylvania","2019","First major","'14'","Engineering","Bachelor's degree","286","180","106","0","0","0","64","41","23","9","4","5","31","19","12","0","0","0","138","89","49","7","3","4","3","2","1","34","22","12","-2"
"215062","University of Pennsylvania","2019","First major","'14'","Engineering","Master's degree","277","184","93","0","0","0","28","20","8","4","3","1","11","6","5","0","0","0","48","35","13","7","4","3","0","0","0","179","116","63","-2"
"215062","University of Pennsylvania","2019","First major","'14'","Engineering","Doctor's degree - research/scholarship","47","34","13","0","0","0","6","3","3","1","1","0","2","1","1","0","0","0","14","13","1","0","0","0","0","0","0","24","16","8","-2"
"215062","University of Pennsylvania","2019","Second major","'14'","Engineering","Bachelor's degree","1","1","0","0","0","0","0","0","0","0","0","0","0","0","0","0","0","0","1","1","0","0","0","0","0","0","0","0","0","0","-2"
"215062","University of Pennsylvania","2019","Second major","'14'","Engineering","Master's degree","3","2","1","0","0","0","0","0","0","0","0","0","0","0","0","0","0","0","1","0","1","0","0","0","0","0","0","2","2","0","-2"
"215239","Community College of Philadelphia","2019","First major","'14'","Engineering","Associate's degree","8","8","0","0","0","0","2","2","0","3","3","0","1","1","0","0","0","0","1","1","0","0","0","0","1","1","0","0","0","0","-2"
"215266","University of Pittsburgh-Bradford","2019","First major","'14'","Engineering","Associate's degree","3","3","0","0","0","0","0","0","0","0","0","0","0","0","0","0","0","0","3","3","0","0","0","0","0","0","0","0","0","0","-2"
"215266","University of Pittsburgh-Bradford","2019","First major","'14'","Engineering","Bachelor's degree","5","5","0","0","0","0","0","0","0","0","0","0","0","0","0","0","0","0","5","5","0","0","0","0","0","0","0","0","0","0","-2"
"215284","University of Pittsburgh-Johnstown","2019","First major","'14'","Engineering","Bachelor's degree","56","45","11","1","1","0","0","0","0","1","1","0","0","0","0","0","0","0","51","40","11","1","1","0","1","1","0","1","1","0","-2"
"215293","University of Pittsburgh-Pittsburgh Campus","2019","First major","'14'","Engineering","Bachelor's degree","713","509","204","0","0","0","48","32","16","29","15","14","16","14","2","1","1","0","516","377","139","26","16","10","13","9","4","64","45","19","-2"
"215293","University of Pittsburgh-Pittsburgh Campus","2019","First major","'14'","Engineering","Master's degree","211","156","55","0","0","0","5","4","1","2","2","0","1","1","0","0","0","0","77","52","25","3","3","0","1","1","0","122","93","29","-2"
"215293","University of Pittsburgh-Pittsburgh Campus","2019","First major","'14'","Engineering","Doctor's degree - research/scholarship","78","60","18","0","0","0","7","6","1","4","1","3","1","0","1","0","0","0","24","18","6","2","1","1","0","0","0","40","34","6","-2"
"215293","University of Pittsburgh-Pittsburgh Campus","2019","Second major","'14'","Engineering","Bachelor's degree","6","4","2","0","0","0","2","1","1","0","0","0","0","0","0","0","0","0","4","3","1","0","0","0","0","0","0","0","0","0","-2"
"215442","Point Park University","2019","First major","'14'","Engineering","Bachelor's degree","4","4","0","0","0","0","1","1","0","0","0","0","0","0","0","0","0","0","3","3","0","0","0","0","0","0","0","0","0","0","-2"
"215585","Reading Area Community College","2019","First major","'14'","Engineering","Associate's degree","2","1","1","0","0","0","0","0","0","1","1","0","0","0","0","0","0","0","0","0","0","1","0","1","0","0","0","0","0","0","-2"
"215655","Robert Morris University","2019","First major","'14'","Engineering","Bachelor's degree","129","107","22","0","0","0","1","1","0","2","2","0","2","2","0","0","0","0","65","48","17","2","1","1","2","2","0","55","51","4","-2"
"215743","Saint Francis University","2019","First major","'14'","Engineering","Associate's degree","0","0","0","0","0","0","0","0","0","0","0","0","0","0","0","0","0","0","0","0","0","0","0","0","0","0","0","0","0","0","-2"
"215743","Saint Francis University","2019","First major","'14'","Engineering","Bachelor's degree","14","9","5","0","0","0","0","0","0","0","0","0","1","1","0","0","0","0","12","8","4","0","0","0","1","0","1","0","0","0","-2"
"215798","Saint Vincent College","2019","First major","'14'","Engineering","Bachelor's degree","24","21","3","0","0","0","0","0","0","0","0","0","3","3","0","0","0","0","19","16","3","0","0","0","2","2","0","0","0","0","-2"
"215929","University of Scranton","2019","First major","'14'","Engineering","Associate's degree","0","0","0","0","0","0","0","0","0","0","0","0","0","0","0","0","0","0","0","0","0","0","0","0","0","0","0","0","0","0","-2"
"215929","University of Scranton","2019","First major","'14'","Engineering","Bachelor's degree","10","10","0","0","0","0","0","0","0","1","1","0","0","0","0","1","1","0","8","8","0","0","0","0","0","0","0","0","0","0","-2"
"215929","University of Scranton","2019","First major","'14'","Engineering","Master's degree","9","8","1","0","0","0","2","2","0","0","0","0","0","0","0","0","0","0","6","5","1","0","0","0","0","0","0","1","1","0","-2"
"216010","Shippensburg University of Pennsylvania","2019","First major","'14'","Engineering","Bachelor's degree","11","9","2","0","0","0","2","1","1","1","1","0","0","0","0","0","0","0","8","7","1","0","0","0","0","0","0","0","0","0","-2"
"216287","Swarthmore College","2019","First major","'14'","Engineering","Bachelor's degree","31","24","7","0","0","0","7","6","1","5","5","0","4","4","0","0","0","0","8","4","4","2","1","1","0","0","0","5","4","1","-2"
"216296","Thaddeus Stevens College of Technology","2019","First major","'14'","Engineering","Associate's degree","30","30","0","0","0","0","1","1","0","0","0","0","4","4","0","0","0","0","22","22","0","3","3","0","0","0","0","0","0","0","-2"
"216339","Temple University","2019","First major","'14'","Engineering","Bachelor's degree","336","264","72","1","1","0","47","38","9","32","26","6","17","11","6","0","0","0","163","134","29","5","3","2","12","8","4","59","43","16","-2"
"216339","Temple University","2019","First major","'14'","Engineering","Master's degree","38","30","8","0","0","0","4","4","0","2","1","1","1","0","1","0","0","0","15","14","1","0","0","0","0","0","0","16","11","5","-2"
"216339","Temple University","2019","First major","'14'","Engineering","Doctor's degree - research/scholarship","12","7","5","0","0","0","2","1","1","0","0","0","0","0","0","0","0","0","3","3","0","0","0","0","0","0","0","7","3","4","-2"
"216357","Thiel College","2019","First major","'14'","Engineering","Bachelor's degree","0","0","0","0","0","0","0","0","0","0","0","0","0","0","0","0","0","0","0","0","0","0","0","0","0","0","0","0","0","0","-2"
"216366","Thomas Jefferson University","2019","First major","'14'","Engineering","Bachelor's degree","17","13","4","0","0","0","1","1","0","1","1","0","3","2","1","0","0","0","7","5","2","0","0","0","2","1","1","3","3","0","-2"
"216366","Thomas Jefferson University","2019","First major","'14'","Engineering","Master's degree","7","1","6","0","0","0","0","0","0","2","0","2","0","0","0","0","0","0","2","0","2","0","0","0","1","0","1","2","1","1","-2"
"216366","Thomas Jefferson University","2019","First major","'14'","Engineering","Doctor's degree - research/scholarship","1","1","0","0","0","0","0","0","0","0","0","0","0","0","0","0","0","0","1","1","0","0","0","0","0","0","0","0","0","0","-2"
"216524","Ursinus College","2019","First major","'14'","Engineering","Bachelor's degree","1","1","0","0","0","0","0","0","0","0","0","0","0","0","0","0","0","0","1","1","0","0","0","0","0","0","0","0","0","0","-2"
"216524","Ursinus College","2019","Second major","'14'","Engineering","Bachelor's degree","1","0","1","0","0","0","1","0","1","0","0","0","0","0","0","0","0","0","0","0","0","0","0","0","0","0","0","0","0","0","-2"
"216597","Villanova University","2019","First major","'14'","Engineering","Bachelor's degree","239","168","71","0","0","0","15","12","3","10","6","4","6","5","1","0","0","0","194","135","59","6","4","2","2","2","0","6","4","2","-2"
"216597","Villanova University","2019","First major","'14'","Engineering","Master's degree","142","91","51","0","0","0","7","6","1","3","3","0","7","1","6","0","0","0","94","65","29","2","1","1","11","6","5","18","9","9","-2"
"216597","Villanova University","2019","First major","'14'","Engineering","Doctor's degree - research/scholarship","8","6","2","0","0","0","1","1","0","0","0","0","0","0","0","0","0","0","3","1","2","0","0","0","1","1","0","3","3","0","-2"
"216807","Westminster College","2019","First major","'14'","Engineering","Bachelor's degree","2","1","1","0","0","0","0","0","0","0","0","0","0","0","0","0","0","0","1","0","1","0","0","0","1","1","0","0","0","0","-2"
"216825","Westmoreland County Community College","2019","First major","'14'","Engineering","Associate's degree","0","0","0","0","0","0","0","0","0","0","0","0","0","0","0","0","0","0","0","0","0","0","0","0","0","0","0","0","0","0","-2"
"216852","Widener University","2019","First major","'14'","Engineering","Associate's degree","0","0","0","0","0","0","0","0","0","0","0","0","0","0","0","0","0","0","0","0","0","0","0","0","0","0","0","0","0","0","-2"
"216852","Widener University","2019","First major","'14'","Engineering","Bachelor's degree","130","103","27","1","1","0","3","2","1","7","5","2","6","3","3","0","0","0","108","89","19","2","1","1","0","0","0","3","2","1","-2"
"216852","Widener University","2019","First major","'14'","Engineering","Master's degree","26","15","11","0","0","0","1","0","1","0","0","0","1","1","0","0","0","0","23","13","10","1","1","0","0","0","0","0","0","0","-2"
"216931","Wilkes University","2019","First major","'14'","Engineering","Bachelor's degree","94","87","7","0","0","0","0","0","0","2","2","0","2","2","0","0","0","0","61","57","4","1","1","0","2","1","1","26","24","2","-2"
"216931","Wilkes University","2019","First major","'14'","Engineering","Master's degree","7","6","1","0","0","0","2","1","1","0","0","0","0","0","0","0","0","0","3","3","0","0","0","0","0","0","0","2","2","0","-2"
"216931","Wilkes University","2019","Second major","'14'","Engineering","Bachelor's degree","1","1","0","0","0","0","0","0","0","0","0","0","0","0","0","0","0","0","1","1","0","0","0","0","0","0","0","0","0","0","-2"
"217059","York College of Pennsylvania","2019","First major","'14'","Engineering","Bachelor's degree","58","54","4","0","0","0","0","0","0","0","0","0","2","2","0","1","1","0","53","49","4","2","2","0","0","0","0","0","0","0","-2"
"217156","Brown University","2019","First major","'14'","Engineering","Bachelor's degree","114","60","54","0","0","0","21","12","9","4","2","2","13","6","7","0","0","0","46","24","22","13","9","4","8","3","5","9","4","5","-2"
"217156","Brown University","2019","First major","'14'","Engineering","Master's degree","81","50","31","0","0","0","6","5","1","2","2","0","3","2","1","0","0","0","19","12","7","4","2","2","1","1","0","46","26","20","-2"
"217156","Brown University","2019","First major","'14'","Engineering","Doctor's degree - research/scholarship","29","25","4","0","0","0","1","1","0","0","0","0","1","1","0","0","0","0","12","9","3","0","0","0","1","1","0","14","13","1","-2"
"217156","Brown University","2019","Second major","'14'","Engineering","Bachelor's degree","4","3","1","0","0","0","0","0","0","0","0","0","0","0","0","0","0","0","2","2","0","1","1","0","0","0","0","1","0","1","-2"
"217235","Johnson & Wales University-Providence","2019","First major","'14'","Engineering","Bachelor's degree","46","43","3","0","0","0","0","0","0","7","6","1","4","4","0","0","0","0","16","15","1","1","1","0","0","0","0","18","17","1","-2"
"217402","Providence College","2019","First major","'14'","Engineering","Bachelor's degree","12","7","5","0","0","0","1","0","1","1","1","0","2","1","1","0","0","0","8","5","3","0","0","0","0","0","0","0","0","0","-2"
"217402","Providence College","2019","Second major","'14'","Engineering","Bachelor's degree","1","1","0","0","0","0","0","0","0","0","0","0","0","0","0","0","0","0","1","1","0","0","0","0","0","0","0","0","0","0","-2"
"217475","Community College of Rhode Island","2019","First major","'14'","Engineering","Associate's degree","9","6","3","0","0","0","1","1","0","1","1","0","0","0","0","0","0","0","7","4","3","0","0","0","0","0","0","0","0","0","-2"
"217484","University of Rhode Island","2019","First major","'14'","Engineering","Bachelor's degree","325","258","67","0","0","0","10","7","3","11","8","3","18","11","7","0","0","0","253","202","51","8","7","1","19","17","2","6","6","0","-2"
"217484","University of Rhode Island","2019","First major","'14'","Engineering","Master's degree","79","65","14","0","0","0","9","6","3","0","0","0","3","3","0","0","0","0","41","37","4","2","1","1","4","3","1","20","15","5","-2"
"217484","University of Rhode Island","2019","First major","'14'","Engineering","Doctor's degree - research/scholarship","16","11","5","1","0","1","5","4","1","0","0","0","1","1","0","0","0","0","6","4","2","0","0","0","2","1","1","1","1","0","-2"
"217518","Roger Williams University","2019","First major","'14'","Engineering","Bachelor's degree","54","45","9","0","0","0","1","1","0","0","0","0","2","2","0","0","0","0","44","35","9","0","0","0","0","0","0","7","7","0","-2"
"217633","Anderson University","2019","First major","'14'","Engineering","Bachelor's degree","3","3","0","0","0","0","0","0","0","0","0","0","1","1","0","0","0","0","2","2","0","0","0","0","0","0","0","0","0","0","-2"
"217721","Benedict College","2019","First major","'14'","Engineering","Bachelor's degree","10","6","4","0","0","0","0","0","0","7","3","4","3","3","0","0","0","0","0","0","0","0","0","0","0","0","0","0","0","0","-2"
"217749","Bob Jones University","2019","First major","'14'","Engineering","Bachelor's degree","19","16","3","0","0","0","2","2","0","0","0","0","2","2","0","0","0","0","14","11","3","0","0","0","0","0","0","1","1","0","-2"
"217749","Bob Jones University","2019","First major","'14'","Engineering","Master's degree","0","0","0","0","0","0","0","0","0","0","0","0","0","0","0","0","0","0","0","0","0","0","0","0","0","0","0","0","0","0","-2"
"217819","College of Charleston","2019","First major","'14'","Engineering","Bachelor's degree","0","0","0","0","0","0","0","0","0","0","0","0","0","0","0","0","0","0","0","0","0","0","0","0","0","0","0","0","0","0","-2"
"217864","Citadel Military College of South Carolina","2019","First major","'14'","Engineering","Bachelor's degree","155","146","9","0","0","0","6","5","1","14","14","0","2","1","1","0","0","0","121","115","6","4","4","0","6","5","1","2","2","0","-2"
"217864","Citadel Military College of South Carolina","2019","First major","'14'","Engineering","Master's degree","12","10","2","0","0","0","0","0","0","0","0","0","0","0","0","0","0","0","12","10","2","0","0","0","0","0","0","0","0","0","-2"
"217873","Claflin University","2019","First major","'14'","Engineering","Bachelor's degree","6","3","3","0","0","0","0","0","0","5","3","2","1","0","1","0","0","0","0","0","0","0","0","0","0","0","0","0","0","0","-2"
"217882","Clemson University","2019","First major","'14'","Engineering","Bachelor's degree","951","719","232","3","2","1","37","29","8","31","19","12","33","26","7","0","0","0","804","613","191","27","16","11","3","3","0","13","11","2","-2"
"217882","Clemson University","2019","First major","'14'","Engineering","Master's degree","328","240","88","0","0","0","10","7","3","7","3","4","7","6","1","0","0","0","139","96","43","4","2","2","3","1","2","158","125","33","-2"
"217882","Clemson University","2019","First major","'14'","Engineering","Doctor's degree - research/scholarship","86","64","22","0","0","0","2","0","2","0","0","0","1","0","1","0","0","0","23","18","5","0","0","0","4","3","1","56","43","13","-2"
"218061","Francis Marion University","2019","First major","'14'","Engineering","Bachelor's degree","0","0","0","0","0","0","0","0","0","0","0","0","0","0","0","0","0","0","0","0","0","0","0","0","0","0","0","0","0","0","-2"
"218070","Furman University","2019","First major","'14'","Engineering","Bachelor's degree","2","2","0","0","0","0","0","0","0","0","0","0","0","0","0","0","0","0","2","2","0","0","0","0","0","0","0","0","0","0","-2"
"218113","Greenville Technical College","2019","First major","'14'","Engineering","Bachelor's degree","0","0","0","0","0","0","0","0","0","0","0","0","0","0","0","0","0","0","0","0","0","0","0","0","0","0","0","0","0","0","-2"
"218645","University of South Carolina Aiken","2019","First major","'14'","Engineering","Bachelor's degree","11","8","3","0","0","0","1","1","0","3","2","1","1","1","0","0","0","0","5","4","1","1","0","1","0","0","0","0","0","0","-2"
"218663","University of South Carolina-Columbia","2019","First major","'14'","Engineering","Bachelor's degree","478","369","109","0","0","0","17","12","5","29","24","5","25","20","5","0","0","0","346","266","80","18","12","6","3","2","1","40","33","7","-2"
"218663","University of South Carolina-Columbia","2019","First major","'14'","Engineering","Master's degree","66","56","10","0","0","0","1","0","1","1","1","0","4","4","0","0","0","0","31","26","5","4","3","1","0","0","0","25","22","3","-2"
"218663","University of South Carolina-Columbia","2019","First major","'14'","Engineering","Doctor's degree - research/scholarship","45","35","10","0","0","0","0","0","0","0","0","0","1","1","0","0","0","0","10","5","5","2","1","1","0","0","0","32","28","4","-2"
"218724","Coastal Carolina University","2019","First major","'14'","Engineering","Bachelor's degree","0","0","0","0","0","0","0","0","0","0","0","0","0","0","0","0","0","0","0","0","0","0","0","0","0","0","0","0","0","0","-2"
"218724","Coastal Carolina University","2019","Second major","'14'","Engineering","Bachelor's degree","1","0","1","0","0","0","0","0","0","0","0","0","1","0","1","0","0","0","0","0","0","0","0","0","0","0","0","0","0","0","-2"
"218733","South Carolina State University","2019","First major","'14'","Engineering","Bachelor's degree","5","3","2","0","0","0","1","0","1","3","2","1","0","0","0","0","0","0","1","1","0","0","0","0","0","0","0","0","0","0","-2"
"218733","South Carolina State University","2019","First major","'14'","Engineering","Master's degree","0","0","0","0","0","0","0","0","0","0","0","0","0","0","0","0","0","0","0","0","0","0","0","0","0","0","0","0","0","0","-2"
"218742","University of South Carolina-Upstate","2019","First major","'14'","Engineering","Bachelor's degree","0","0","0","0","0","0","0","0","0","0","0","0","0","0","0","0","0","0","0","0","0","0","0","0","0","0","0","0","0","0","-2"
"219000","Augustana University","2019","First major","'14'","Engineering","Bachelor's degree","1","1","0","0","0","0","0","0","0","0","0","0","0","0","0","0","0","0","0","0","0","0","0","0","0","0","0","1","1","0","-2"
"219347","South Dakota School of Mines and Technology","2019","First major","'14'","Engineering","Bachelor's degree","348","272","76","4","2","2","8","7","1","5","5","0","16","12","4","0","0","0","294","229","65","12","9","3","1","1","0","8","7","1","-2"
"219347","South Dakota School of Mines and Technology","2019","First major","'14'","Engineering","Master's degree","77","58","19","1","1","0","4","2","2","2","2","0","3","3","0","0","0","0","48","34","14","2","2","0","0","0","0","17","14","3","-2"
"219347","South Dakota School of Mines and Technology","2019","First major","'14'","Engineering","Doctor's degree - research/scholarship","12","9","3","0","0","0","0","0","0","0","0","0","0","0","0","0","0","0","6","5","1","0","0","0","0","0","0","6","4","2","-2"
"219356","South Dakota State University","2019","First major","'14'","Engineering","Bachelor's degree","136","117","19","1","0","1","0","0","0","1","1","0","1","1","0","0","0","0","115","98","17","3","3","0","0","0","0","15","14","1","-2"
"219356","South Dakota State University","2019","First major","'14'","Engineering","Master's degree","60","50","10","0","0","0","4","3","1","0","0","0","1","1","0","0","0","0","11","8","3","0","0","0","0","0","0","44","38","6","-2"
"219356","South Dakota State University","2019","First major","'14'","Engineering","Doctor's degree - research/scholarship","5","3","2","0","0","0","0","0","0","0","0","0","0","0","0","0","0","0","1","0","1","0","0","0","0","0","0","4","3","1","-2"
"219356","South Dakota State University","2019","Second major","'14'","Engineering","Master's degree","1","1","0","0","0","0","0","0","0","0","0","0","0","0","0","0","0","0","0","0","0","0","0","0","0","0","0","1","1","0","-2"
"219471","University of South Dakota","2019","First major","'14'","Engineering","Master's degree","2","1","1","0","0","0","0","0","0","0","0","0","0","0","0","0","0","0","2","1","1","0","0","0","0","0","0","0","0","0","-2"
"219471","University of South Dakota","2019","First major","'14'","Engineering","Doctor's degree - research/scholarship","2","2","0","0","0","0","0","0","0","0","0","0","0","0","0","0","0","0","2","2","0","0","0","0","0","0","0","0","0","0","-2"
"219602","Austin Peay State University","2019","First major","'14'","Engineering","Bachelor's degree","0","0","0","0","0","0","0","0","0","0","0","0","0","0","0","0","0","0","0","0","0","0","0","0","0","0","0","0","0","0","-2"
"219709","Belmont University","2019","First major","'14'","Engineering","Bachelor's degree","0","0","0","0","0","0","0","0","0","0","0","0","0","0","0","0","0","0","0","0","0","0","0","0","0","0","0","0","0","0","-2"
"219790","Bryan College-Dayton","2019","First major","'14'","Engineering","Bachelor's degree","0","0","0","0","0","0","0","0","0","0","0","0","0","0","0","0","0","0","0","0","0","0","0","0","0","0","0","0","0","0","-2"
"219806","Carson-Newman University","2019","First major","'14'","Engineering","Bachelor's degree","0","0","0","0","0","0","0","0","0","0","0","0","0","0","0","0","0","0","0","0","0","0","0","0","0","0","0","0","0","0","-2"
"219824","Chattanooga State Community College","2019","First major","'14'","Engineering","Associate's degree","42","36","6","0","0","0","2","1","1","2","2","0","3","2","1","0","0","0","33","29","4","1","1","0","0","0","0","1","1","0","-2"
"219833","Christian Brothers University","2019","First major","'14'","Engineering","Bachelor's degree","46","38","8","1","0","1","5","3","2","2","2","0","6","5","1","0","0","0","23","20","3","1","0","1","6","6","0","2","2","0","-2"
"219833","Christian Brothers University","2019","Second major","'14'","Engineering","Bachelor's degree","9","8","1","0","0","0","1","1","0","0","0","0","1","1","0","0","0","0","7","6","1","0","0","0","0","0","0","0","0","0","-2"
"219976","Lipscomb University","2019","First major","'14'","Engineering","Bachelor's degree","39","35","4","0","0","0","1","1","0","1","1","0","2","2","0","0","0","0","28","24","4","2","2","0","0","0","0","5","5","0","-2"
"219976","Lipscomb University","2019","First major","'14'","Engineering","Master's degree","4","2","2","0","0","0","1","1","0","0","0","0","1","0","1","0","0","0","1","1","0","0","0","0","0","0","0","1","0","1","-2"
"219976","Lipscomb University","2019","Second major","'14'","Engineering","Bachelor's degree","1","0","1","0","0","0","0","0","0","0","0","0","0","0","0","0","0","0","1","0","1","0","0","0","0","0","0","0","0","0","-2"
"220215","Freed-Hardeman University","2019","First major","'14'","Engineering","Bachelor's degree","1","1","0","0","0","0","0","0","0","0","0","0","0","0","0","0","0","0","1","1","0","0","0","0","0","0","0","0","0","0","-2"
"220710","Maryville College","2019","First major","'14'","Engineering","Bachelor's degree","3","3","0","0","0","0","0","0","0","0","0","0","0","0","0","0","0","0","2","2","0","0","0","0","0","0","0","1","1","0","-2"
"220862","University of Memphis","2019","First major","'14'","Engineering","Bachelor's degree","135","109","26","0","0","0","13","11","2","12","9","3","10","6","4","0","0","0","85","72","13","11","7","4","1","1","0","3","3","0","-2"
"220862","University of Memphis","2019","First major","'14'","Engineering","Master's degree","26","16","10","0","0","0","0","0","0","1","1","0","0","0","0","0","0","0","10","6","4","0","0","0","0","0","0","15","9","6","-2"
"220862","University of Memphis","2019","First major","'14'","Engineering","Doctor's degree - research/scholarship","7","4","3","0","0","0","1","1","0","0","0","0","0","0","0","0","0","0","1","1","0","0","0","0","0","0","0","5","2","3","-2"
"220978","Middle Tennessee State University","2019","First major","'14'","Engineering","Bachelor's degree","79","68","11","0","0","0","3","2","1","4","3","1","5","3","2","0","0","0","48","42","6","1","1","0","1","1","0","17","16","1","-2"
"221661","Southern Adventist University","2019","First major","'14'","Engineering","Associate's degree","0","0","0","0","0","0","0","0","0","0","0","0","0","0","0","0","0","0","0","0","0","0","0","0","0","0","0","0","0","0","-2"
"221661","Southern Adventist University","2019","First major","'14'","Engineering","Bachelor's degree","0","0","0","0","0","0","0","0","0","0","0","0","0","0","0","0","0","0","0","0","0","0","0","0","0","0","0","0","0","0","-2"
"221740","The University of Tennessee-Chattanooga","2019","First major","'14'","Engineering","Bachelor's degree","179","152","27","2","1","1","6","3","3","8","5","3","6","5","1","0","0","0","110","95","15","7","6","1","5","5","0","35","32","3","-2"
"221740","The University of Tennessee-Chattanooga","2019","First major","'14'","Engineering","Master's degree","27","24","3","0","0","0","3","2","1","4","3","1","2","2","0","0","0","0","8","8","0","1","1","0","0","0","0","9","8","1","-2"
"221740","The University of Tennessee-Chattanooga","2019","First major","'14'","Engineering","Doctor's degree - research/scholarship","0","0","0","0","0","0","0","0","0","0","0","0","0","0","0","0","0","0","0","0","0","0","0","0","0","0","0","0","0","0","-2"
"221740","The University of Tennessee-Chattanooga","2019","Second major","'14'","Engineering","Bachelor's degree","3","2","1","0","0","0","1","0","1","0","0","0","0","0","0","0","0","0","2","2","0","0","0","0","0","0","0","0","0","0","-2"
"221759","The University of Tennessee-Knoxville","2019","First major","'14'","Engineering","Bachelor's degree","565","434","131","0","0","0","24","22","2","19","13","6","14","7","7","1","1","0","470","363","107","9","6","3","13","11","2","15","11","4","-2"
"221759","The University of Tennessee-Knoxville","2019","First major","'14'","Engineering","Master's degree","197","152","45","0","0","0","7","5","2","4","4","0","8","6","2","0","0","0","142","110","32","1","1","0","2","0","2","33","26","7","-2"
"221759","The University of Tennessee-Knoxville","2019","First major","'14'","Engineering","Doctor's degree - research/scholarship","114","89","25","0","0","0","3","2","1","0","0","0","4","3","1","0","0","0","38","29","9","1","1","0","6","3","3","62","51","11","-2"
"221768","The University of Tennessee-Martin","2019","First major","'14'","Engineering","Bachelor's degree","24","20","4","0","0","0","0","0","0","1","1","0","1","0","1","0","0","0","22","19","3","0","0","0","0","0","0","0","0","0","-2"
"221838","Tennessee State University","2019","First major","'14'","Engineering","Bachelor's degree","55","44","11","0","0","0","0","0","0","19","11","8","1","1","0","0","0","0","18","15","3","1","1","0","0","0","0","16","16","0","-2"
"221838","Tennessee State University","2019","First major","'14'","Engineering","Master's degree","19","15","4","0","0","0","0","0","0","3","3","0","0","0","0","0","0","0","1","0","1","0","0","0","0","0","0","15","12","3","-2"
"221838","Tennessee State University","2019","First major","'14'","Engineering","Doctor's degree - research/scholarship","7","4","3","0","0","0","0","0","0","0","0","0","0","0","0","0","0","0","1","1","0","1","1","0","0","0","0","5","2","3","-2"
"221847","Tennessee Technological University","2019","First major","'14'","Engineering","Bachelor's degree","322","271","51","0","0","0","6","5","1","12","10","2","11","8","3","0","0","0","235","193","42","6","4","2","2","2","0","50","49","1","-2"
"221847","Tennessee Technological University","2019","First major","'14'","Engineering","Master's degree","32","26","6","0","0","0","0","0","0","1","0","1","0","0","0","0","0","0","18","16","2","0","0","0","0","0","0","13","10","3","-2"
"221847","Tennessee Technological University","2019","First major","'14'","Engineering","Doctor's degree - research/scholarship","15","13","2","0","0","0","0","0","0","0","0","0","1","1","0","0","0","0","7","6","1","0","0","0","0","0","0","7","6","1","-2"
"221892","Trevecca Nazarene University","2019","First major","'14'","Engineering","Bachelor's degree","1","1","0","0","0","0","0","0","0","0","0","0","0","0","0","0","0","0","0","0","0","1","1","0","0","0","0","0","0","0","-2"
"221971","Union University","2019","First major","'14'","Engineering","Bachelor's degree","11","9","2","0","0","0","1","0","1","0","0","0","0","0","0","0","0","0","10","9","1","0","0","0","0","0","0","0","0","0","-2"
"221999","Vanderbilt University","2019","First major","'14'","Engineering","Bachelor's degree","267","182","85","2","2","0","38","29","9","20","11","9","20","11","9","1","0","1","128","94","34","12","5","7","15","12","3","31","18","13","-2"
"221999","Vanderbilt University","2019","First major","'14'","Engineering","Master's degree","35","27","8","0","0","0","0","0","0","1","1","0","0","0","0","0","0","0","17","12","5","1","0","1","0","0","0","16","14","2","-2"
"221999","Vanderbilt University","2019","First major","'14'","Engineering","Doctor's degree - research/scholarship","51","34","17","0","0","0","4","2","2","4","3","1","2","2","0","0","0","0","20","11","9","0","0","0","2","2","0","19","14","5","-2"
"221999","Vanderbilt University","2019","Second major","'14'","Engineering","Bachelor's degree","10","6","4","0","0","0","2","2","0","0","0","0","1","0","1","0","0","0","4","2","2","0","0","0","0","0","0","3","2","1","-2"
"222178","Abilene Christian University","2019","First major","'14'","Engineering","Bachelor's degree","16","11","5","0","0","0","0","0","0","1","0","1","7","4","3","0","0","0","7","6","1","1","1","0","0","0","0","0","0","0","-2"
"222576","Amarillo College","2019","First major","'14'","Engineering","Associate's degree","26","23","3","0","0","0","2","2","0","1","1","0","8","5","3","0","0","0","14","14","0","1","1","0","0","0","0","0","0","0","-2"
"222822","Angelina College","2019","First major","'14'","Engineering","Associate's degree","1","1","0","0","0","0","0","0","0","0","0","0","0","0","0","0","0","0","1","1","0","0","0","0","0","0","0","0","0","0","-2"
"222831","Angelo State University","2019","First major","'14'","Engineering","Bachelor's degree","13","11","2","0","0","0","0","0","0","0","0","0","3","2","1","0","0","0","9","8","1","0","0","0","0","0","0","1","1","0","-2"
"222992","Austin Community College District","2019","First major","'14'","Engineering","Associate's degree","79","64","15","0","0","0","6","6","0","5","3","2","23","19","4","0","0","0","37","31","6","4","3","1","1","0","1","3","2","1","-2"
"223232","Baylor University","2019","First major","'14'","Engineering","Bachelor's degree","171","127","44","0","0","0","3","2","1","7","5","2","24","15","9","0","0","0","112","86","26","12","8","4","0","0","0","13","11","2","-2"
"223232","Baylor University","2019","First major","'14'","Engineering","Master's degree","15","13","2","0","0","0","0","0","0","0","0","0","1","1","0","0","0","0","4","4","0","2","2","0","0","0","0","8","6","2","-2"
"223232","Baylor University","2019","First major","'14'","Engineering","Doctor's degree - research/scholarship","4","3","1","0","0","0","1","1","0","0","0","0","0","0","0","0","0","0","1","1","0","0","0","0","0","0","0","2","1","1","-2"
"223320","Coastal Bend College","2019","First major","'14'","Engineering","Associate's degree","0","0","0","0","0","0","0","0","0","0","0","0","0","0","0","0","0","0","0","0","0","0","0","0","0","0","0","0","0","0","-2"
"223427","Blinn College","2019","First major","'14'","Engineering","Associate's degree","10","9","1","0","0","0","0","0","0","0","0","0","2","2","0","0","0","0","7","7","0","1","0","1","0","0","0","0","0","0","-2"
"223816","Central Texas College","2019","First major","'14'","Engineering","Associate's degree","3","3","0","0","0","0","0","0","0","0","0","0","2","2","0","0","0","0","1","1","0","0","0","0","0","0","0","0","0","0","-2"
"224147","Texas A & M University-Corpus Christi","2019","First major","'14'","Engineering","Bachelor's degree","82","66","16","1","1","0","4","2","2","1","1","0","36","31","5","0","0","0","36","28","8","0","0","0","1","1","0","3","2","1","-2"
"224147","Texas A & M University-Corpus Christi","2019","First major","'14'","Engineering","Master's degree","7","3","4","0","0","0","0","0","0","0","0","0","2","1","1","0","0","0","3","1","2","1","1","0","0","0","0","1","0","1","-2"
"224350","Del Mar College","2019","First major","'14'","Engineering","Associate's degree","12","10","2","0","0","0","1","1","0","0","0","0","7","7","0","0","0","0","4","2","2","0","0","0","0","0","0","0","0","0","-2"
"224545","Texas A&M University-Texarkana","2019","First major","'14'","Engineering","Bachelor's degree","9","9","0","0","0","0","0","0","0","0","0","0","0","0","0","0","0","0","9","9","0","0","0","0","0","0","0","0","0","0","-2"
"224554","Texas A & M University-Commerce","2019","First major","'14'","Engineering","Bachelor's degree","33","26","7","0","0","0","1","1","0","5","3","2","8","7","1","0","0","0","16","12","4","1","1","0","0","0","0","2","2","0","-2"
"224642","El Paso Community College","2019","First major","'14'","Engineering","Associate's degree","81","69","12","0","0","0","1","1","0","0","0","0","68","56","12","0","0","0","6","6","0","0","0","0","0","0","0","6","6","0","-2"
"224891","Frank Phillips College","2019","First major","'14'","Engineering","Associate's degree","0","0","0","0","0","0","0","0","0","0","0","0","0","0","0","0","0","0","0","0","0","0","0","0","0","0","0","0","0","0","-2"
"225070","Grayson College","2019","First major","'14'","Engineering","Associate's degree","1","1","0","0","0","0","0","0","0","0","0","0","0","0","0","0","0","0","1","1","0","0","0","0","0","0","0","0","0","0","-2"
"225399","Houston Baptist University","2019","First major","'14'","Engineering","Bachelor's degree","0","0","0","0","0","0","0","0","0","0","0","0","0","0","0","0","0","0","0","0","0","0","0","0","0","0","0","0","0","0","-2"
"225414","University of Houston-Clear Lake","2019","First major","'14'","Engineering","Bachelor's degree","36","29","7","1","1","0","7","6","1","0","0","0","10","8","2","0","0","0","13","12","1","2","1","1","1","1","0","2","0","2","-2"
"225414","University of Houston-Clear Lake","2019","First major","'14'","Engineering","Master's degree","86","54","32","0","0","0","5","3","2","2","2","0","2","1","1","0","0","0","5","5","0","0","0","0","2","2","0","70","41","29","-2"
"225423","Houston Community College","2019","First major","'14'","Engineering","Associate's degree","112","89","23","0","0","0","18","16","2","13","12","1","33","28","5","0","0","0","20","16","4","2","2","0","1","0","1","25","15","10","-2"
"225511","University of Houston","2019","First major","'14'","Engineering","Bachelor's degree","700","512","188","2","2","0","157","116","41","40","26","14","195","139","56","3","2","1","188","151","37","16","11","5","19","11","8","80","54","26","-2"
"225511","University of Houston","2019","First major","'14'","Engineering","Master's degree","360","283","77","2","1","1","38","30","8","6","3","3","16","10","6","0","0","0","52","42","10","2","2","0","5","3","2","239","192","47","-2"
"225511","University of Houston","2019","First major","'14'","Engineering","Doctor's degree - research/scholarship","86","58","28","0","0","0","7","4","3","2","0","2","0","0","0","0","0","0","8","5","3","1","0","1","0","0","0","68","49","19","-2"
"225520","Howard College","2019","First major","'14'","Engineering","Associate's degree","3","3","0","0","0","0","0","0","0","1","1","0","1","1","0","0","0","0","1","1","0","0","0","0","0","0","0","0","0","0","-2"
"225548","Howard Payne University","2019","First major","'14'","Engineering","Bachelor's degree","6","5","1","0","0","0","0","0","0","0","0","0","1","1","0","1","1","0","3","3","0","0","0","0","1","0","1","0","0","0","-2"
"225627","University of the Incarnate Word","2019","First major","'14'","Engineering","Bachelor's degree","5","3","2","0","0","0","0","0","0","0","0","0","3","3","0","0","0","0","0","0","0","0","0","0","0","0","0","2","0","2","-2"
"226091","Lamar University","2019","First major","'14'","Engineering","Bachelor's degree","225","172","53","0","0","0","22","13","9","31","26","5","49","36","13","0","0","0","108","88","20","6","4","2","0","0","0","9","5","4","-2"
"226091","Lamar University","2019","First major","'14'","Engineering","Master's degree","99","87","12","0","0","0","1","1","0","1","1","0","0","0","0","0","0","0","4","2","2","1","1","0","0","0","0","92","82","10","-2"
"226091","Lamar University","2019","First major","'14'","Engineering","Doctor's degree - research/scholarship","15","8","7","0","0","0","1","1","0","0","0","0","0","0","0","0","0","0","1","0","1","0","0","0","0","0","0","13","7","6","-2"
"226152","Texas A & M International University","2019","First major","'14'","Engineering","Bachelor's degree","34","23","11","0","0","0","0","0","0","0","0","0","34","23","11","0","0","0","0","0","0","0","0","0","0","0","0","0","0","0","-2"
"226204","Lee College","2019","First major","'14'","Engineering","Associate's degree","8","5","3","0","0","0","0","0","0","0","0","0","7","4","3","0","0","0","1","1","0","0","0","0","0","0","0","0","0","0","-2"
"226231","LeTourneau University","2019","First major","'14'","Engineering","Bachelor's degree","101","84","17","0","0","0","2","2","0","0","0","0","4","2","2","0","0","0","76","63","13","1","1","0","9","9","0","9","7","2","-2"
"226231","LeTourneau University","2019","First major","'14'","Engineering","Master's degree","6","5","1","0","0","0","0","0","0","0","0","0","0","0","0","0","0","0","5","4","1","0","0","0","0","0","0","1","1","0","-2"
"226231","LeTourneau University","2019","Second major","'14'","Engineering","Bachelor's degree","1","1","0","0","0","0","0","0","0","0","0","0","0","0","0","0","0","0","1","1","0","0","0","0","0","0","0","0","0","0","-2"
"226471","University of Mary Hardin-Baylor","2019","First major","'14'","Engineering","Bachelor's degree","9","8","1","0","0","0","0","0","0","1","1","0","2","2","0","0","0","0","6","5","1","0","0","0","0","0","0","0","0","0","-2"
"226578","McLennan Community College","2019","First major","'14'","Engineering","Associate's degree","20","18","2","1","0","1","1","1","0","0","0","0","4","3","1","0","0","0","12","12","0","0","0","0","2","2","0","0","0","0","-2"
"226806","Midland College","2019","First major","'14'","Engineering","Associate's degree","0","0","0","0","0","0","0","0","0","0","0","0","0","0","0","0","0","0","0","0","0","0","0","0","0","0","0","0","0","0","-2"
"226833","Midwestern State University","2019","First major","'14'","Engineering","Bachelor's degree","26","19","7","0","0","0","1","1","0","1","1","0","1","0","1","0","0","0","8","6","2","1","1","0","0","0","0","14","10","4","-2"
"227146","Navarro College","2019","First major","'14'","Engineering","Associate's degree","2","2","0","0","0","0","0","0","0","0","0","0","0","0","0","0","0","0","1","1","0","0","0","0","0","0","0","1","1","0","-2"
"227182","Lone Star College System","2019","First major","'14'","Engineering","Associate's degree","58","53","5","0","0","0","5","3","2","3","3","0","18","17","1","0","0","0","21","20","1","2","2","0","1","1","0","8","7","1","-2"
"227216","University of North Texas","2019","First major","'14'","Engineering","Bachelor's degree","305","255","50","0","0","0","15","14","1","25","19","6","59","48","11","0","0","0","123","102","21","27","20","7","3","3","0","53","49","4","-2"
"227216","University of North Texas","2019","First major","'14'","Engineering","Master's degree","74","59","15","0","0","0","1","1","0","4","3","1","4","1","3","0","0","0","17","16","1","3","3","0","1","1","0","44","34","10","-2"
"227216","University of North Texas","2019","First major","'14'","Engineering","Doctor's degree - research/scholarship","13","10","3","0","0","0","1","1","0","0","0","0","0","0","0","0","0","0","0","0","0","0","0","0","0","0","0","12","9","3","-2"
"227304","Odessa College","2019","First major","'14'","Engineering","Associate's degree","14","11","3","0","0","0","0","0","0","1","1","0","8","6","2","0","0","0","2","1","1","0","0","0","1","1","0","2","2","0","-2"
"227368","The University of Texas Rio Grande Valley","2019","First major","'14'","Engineering","Bachelor's degree","313","256","57","0","0","0","6","4","2","1","0","1","260","219","41","0","0","0","7","6","1","0","0","0","11","8","3","28","19","9","-2"
"227368","The University of Texas Rio Grande Valley","2019","First major","'14'","Engineering","Master's degree","37","30","7","0","0","0","0","0","0","1","1","0","23","19","4","0","0","0","3","2","1","0","0","0","3","3","0","7","5","2","-2"
"227401","Paris Junior College","2019","First major","'14'","Engineering","Associate's degree","9","9","0","0","0","0","0","0","0","0","0","0","3","3","0","0","0","0","5","5","0","0","0","0","0","0","0","1","1","0","-2"
"227526","Prairie View A & M University","2019","First major","'14'","Engineering","Bachelor's degree","172","123","49","0","0","0","13","10","3","116","82","34","24","17","7","0","0","0","6","6","0","2","2","0","0","0","0","11","6","5","-2"
"227526","Prairie View A & M University","2019","First major","'14'","Engineering","Master's degree","36","27","9","0","0","0","3","2","1","16","13","3","0","0","0","0","0","0","3","3","0","0","0","0","1","0","1","13","9","4","-2"
"227526","Prairie View A & M University","2019","First major","'14'","Engineering","Doctor's degree - research/scholarship","1","1","0","0","0","0","0","0","0","0","0","0","0","0","0","0","0","0","0","0","0","0","0","0","0","0","0","1","1","0","-2"
"227757","Rice University","2019","First major","'14'","Engineering","Bachelor's degree","225","158","67","1","1","0","46","30","16","7","4","3","32","24","8","0","0","0","84","62","22","10","7","3","5","2","3","40","28","12","-2"
"227757","Rice University","2019","First major","'14'","Engineering","Master's degree","103","63","40","0","0","0","17","9","8","2","1","1","4","4","0","0","0","0","23","13","10","0","0","0","1","1","0","56","35","21","-2"
"227757","Rice University","2019","First major","'14'","Engineering","Doctor's degree - research/scholarship","73","49","24","0","0","0","5","3","2","1","0","1","4","3","1","0","0","0","20","14","6","2","2","0","2","0","2","39","27","12","-2"
"227854","St Philip's College","2019","First major","'14'","Engineering","Associate's degree","3","2","1","0","0","0","0","0","0","0","0","0","1","1","0","0","0","0","2","1","1","0","0","0","0","0","0","0","0","0","-2"
"227924","San Antonio College","2019","First major","'14'","Engineering","Associate's degree","29","22","7","0","0","0","2","2","0","2","2","0","20","16","4","0","0","0","5","2","3","0","0","0","0","0","0","0","0","0","-2"
"227979","San Jacinto Community College","2019","First major","'14'","Engineering","Associate's degree","40","35","5","0","0","0","4","4","0","1","1","0","15","12","3","0","0","0","14","14","0","0","0","0","2","0","2","4","4","0","-2"
"228149","St. Mary's University","2019","First major","'14'","Engineering","Bachelor's degree","38","29","9","0","0","0","0","0","0","0","0","0","14","7","7","0","0","0","6","6","0","0","0","0","0","0","0","18","16","2","-2"
"228149","St. Mary's University","2019","First major","'14'","Engineering","Master's degree","17","13","4","0","0","0","0","0","0","0","0","0","5","4","1","0","0","0","2","1","1","0","0","0","0","0","0","10","8","2","-2"
"228158","South Plains College","2019","First major","'14'","Engineering","Associate's degree","8","7","1","0","0","0","0","0","0","0","0","0","3","3","0","0","0","0","4","4","0","0","0","0","0","0","0","1","0","1","-2"
"228246","Southern Methodist University","2019","First major","'14'","Engineering","Bachelor's degree","172","98","74","1","0","1","19","10","9","3","1","2","19","14","5","0","0","0","108","59","49","10","6","4","0","0","0","12","8","4","-2"
"228246","Southern Methodist University","2019","First major","'14'","Engineering","Master's degree","220","155","65","0","0","0","15","11","4","15","11","4","15","9","6","0","0","0","83","56","27","7","7","0","1","1","0","84","60","24","-2"
"228246","Southern Methodist University","2019","First major","'14'","Engineering","Doctor's degree - research/scholarship","17","12","5","0","0","0","1","0","1","1","1","0","0","0","0","0","0","0","4","3","1","0","0","0","0","0","0","11","8","3","-2"
"228316","Southwest Texas Junior College","2019","First major","'14'","Engineering","Associate's degree","3","2","1","0","0","0","0","0","0","0","0","0","3","2","1","0","0","0","0","0","0","0","0","0","0","0","0","0","0","0","-2"
"228431","Stephen F Austin State University","2019","First major","'14'","Engineering","Bachelor's degree","23","23","0","0","0","0","2","2","0","1","1","0","4","4","0","0","0","0","14","14","0","2","2","0","0","0","0","0","0","0","-2"
"228459","Texas State University","2019","First major","'14'","Engineering","Bachelor's degree","170","132","38","0","0","0","9","9","0","13","10","3","61","48","13","1","0","1","76","57","19","8","8","0","0","0","0","2","0","2","-2"
"228459","Texas State University","2019","First major","'14'","Engineering","Master's degree","25","19","6","0","0","0","1","0","1","0","0","0","0","0","0","0","0","0","4","4","0","0","0","0","0","0","0","20","15","5","-2"
"228459","Texas State University","2019","First major","'14'","Engineering","Doctor's degree - research/scholarship","4","4","0","0","0","0","1","1","0","2","2","0","0","0","0","0","0","0","1","1","0","0","0","0","0","0","0","0","0","0","-2"
"228459","Texas State University","2019","Second major","'14'","Engineering","Bachelor's degree","1","1","0","0","0","0","0","0","0","0","0","0","0","0","0","0","0","0","1","1","0","0","0","0","0","0","0","0","0","0","-2"
"228529","Tarleton State University","2019","First major","'14'","Engineering","Bachelor's degree","24","20","4","0","0","0","0","0","0","0","0","0","2","2","0","0","0","0","21","18","3","0","0","0","0","0","0","1","0","1","-2"
"228547","Tarrant County College District","2019","First major","'14'","Engineering","Associate's degree","22","16","6","0","0","0","2","1","1","6","6","0","5","3","2","0","0","0","5","4","1","1","1","0","1","0","1","2","1","1","-2"
"228608","Temple College","2019","First major","'14'","Engineering","Associate's degree","0","0","0","0","0","0","0","0","0","0","0","0","0","0","0","0","0","0","0","0","0","0","0","0","0","0","0","0","0","0","-2"
"228635","University of Texas Southwestern Medical Center","2019","First major","'14'","Engineering","Master's degree","0","0","0","0","0","0","0","0","0","0","0","0","0","0","0","0","0","0","0","0","0","0","0","0","0","0","0","0","0","0","-2"
"228635","University of Texas Southwestern Medical Center","2019","First major","'14'","Engineering","Doctor's degree - research/scholarship","5","3","2","0","0","0","0","0","0","0","0","0","0","0","0","0","0","0","0","0","0","0","0","0","0","0","0","5","3","2","-2"
"228644","The University of Texas Health Science Center at San Antonio","2019","First major","'14'","Engineering","Master's degree","3","1","2","0","0","0","0","0","0","1","1","0","0","0","0","0","0","0","0","0","0","1","0","1","1","0","1","0","0","0","-2"
"228644","The University of Texas Health Science Center at San Antonio","2019","First major","'14'","Engineering","Doctor's degree - research/scholarship","0","0","0","0","0","0","0","0","0","0","0","0","0","0","0","0","0","0","0","0","0","0","0","0","0","0","0","0","0","0","-2"
"228699","Texarkana College","2019","First major","'14'","Engineering","Associate's degree","3","3","0","0","0","0","0","0","0","0","0","0","2","2","0","0","0","0","1","1","0","0","0","0","0","0","0","0","0","0","-2"
"228705","Texas A & M University-Kingsville","2019","First major","'14'","Engineering","Bachelor's degree","263","197","66","0","0","0","9","6","3","13","10","3","140","99","41","0","0","0","47","35","12","1","0","1","3","3","0","50","44","6","-2"
"228705","Texas A & M University-Kingsville","2019","First major","'14'","Engineering","Master's degree","245","193","52","0","0","0","3","2","1","7","5","2","18","12","6","0","0","0","5","5","0","0","0","0","0","0","0","212","169","43","-2"
"228705","Texas A & M University-Kingsville","2019","First major","'14'","Engineering","Doctor's degree - research/scholarship","2","1","1","0","0","0","0","0","0","1","0","1","0","0","0","0","0","0","0","0","0","0","0","0","0","0","0","1","1","0","-2"
"228723","Texas A & M University-College Station","2019","First major","'14'","Engineering","Bachelor's degree","2104","1595","509","3","2","1","227","172","55","37","28","9","459","341","118","3","2","1","1254","957","297","53","38","15","6","6","0","62","49","13","-2"
"228723","Texas A & M University-College Station","2019","First major","'14'","Engineering","Master's degree","795","607","188","0","0","0","41","35","6","9","6","3","48","36","12","0","0","0","174","135","39","10","10","0","9","7","2","504","378","126","-2"
"228723","Texas A & M University-College Station","2019","First major","'14'","Engineering","Doctor's degree - research/scholarship","272","215","57","0","0","0","10","9","1","3","0","3","7","6","1","0","0","0","41","31","10","1","0","1","11","7","4","199","162","37","-2"
"228769","The University of Texas at Arlington","2019","First major","'14'","Engineering","Bachelor's degree","513","418","95","2","2","0","69","50","19","40","33","7","127","109","18","0","0","0","188","157","31","26","22","4","2","2","0","59","43","16","-2"
"228769","The University of Texas at Arlington","2019","First major","'14'","Engineering","Master's degree","605","493","112","0","0","0","35","25","10","11","6","5","31","28","3","0","0","0","56","47","9","2","2","0","6","4","2","464","381","83","-2"
"228769","The University of Texas at Arlington","2019","First major","'14'","Engineering","Doctor's degree - research/scholarship","80","58","22","0","0","0","5","3","2","2","1","1","1","1","0","0","0","0","12","11","1","1","0","1","2","2","0","57","40","17","-2"
"228778","The University of Texas at Austin","2019","First major","'14'","Engineering","Bachelor's degree","1286","943","343","0","0","0","443","332","111","25","18","7","177","127","50","0","0","0","522","378","144","45","28","17","14","8","6","60","52","8","-2"
"228778","The University of Texas at Austin","2019","First major","'14'","Engineering","Master's degree","411","288","123","1","0","1","43","27","16","6","4","2","20","13","7","0","0","0","122","87","35","4","2","2","7","6","1","208","149","59","-2"
"228778","The University of Texas at Austin","2019","First major","'14'","Engineering","Doctor's degree - research/scholarship","250","201","49","0","0","0","14","11","3","1","0","1","4","3","1","0","0","0","66","52","14","2","1","1","11","7","4","152","127","25","-2"
"228787","The University of Texas at Dallas","2019","First major","'14'","Engineering","Bachelor's degree","602","484","118","1","1","0","156","122","34","30","24","6","108","88","20","2","2","0","244","196","48","24","19","5","14","12","2","23","20","3","-2"
"228787","The University of Texas at Dallas","2019","First major","'14'","Engineering","Master's degree","346","243","103","0","0","0","21","12","9","4","3","1","12","8","4","0","0","0","48","40","8","5","4","1","8","8","0","248","168","80","-2"
"228787","The University of Texas at Dallas","2019","First major","'14'","Engineering","Doctor's degree - research/scholarship","70","61","9","0","0","0","1","1","0","3","2","1","3","3","0","0","0","0","7","6","1","0","0","0","2","2","0","54","47","7","-2"
"228796","The University of Texas at El Paso","2019","First major","'14'","Engineering","Bachelor's degree","470","375","95","0","0","0","4","3","1","1","0","1","344","268","76","0","0","0","16","13","3","0","0","0","4","4","0","101","87","14","-2"
"228796","The University of Texas at El Paso","2019","First major","'14'","Engineering","Master's degree","141","104","37","0","0","0","0","0","0","2","1","1","92","68","24","0","0","0","9","6","3","0","0","0","1","1","0","37","28","9","-2"
"228796","The University of Texas at El Paso","2019","First major","'14'","Engineering","Doctor's degree - research/scholarship","31","22","9","0","0","0","1","1","0","0","0","0","5","4","1","0","0","0","7","5","2","0","0","0","0","0","0","18","12","6","-2"
"228802","The University of Texas at Tyler","2019","First major","'14'","Engineering","Bachelor's degree","307","244","63","2","2","0","39","29","10","33","28","5","80","65","15","0","0","0","108","91","17","7","5","2","3","2","1","35","22","13","-2"
"228802","The University of Texas at Tyler","2019","First major","'14'","Engineering","Master's degree","24","18","6","0","0","0","0","0","0","1","1","0","1","1","0","0","0","0","0","0","0","0","0","0","0","0","0","22","16","6","-2"
"228875","Texas Christian University","2019","First major","'14'","Engineering","Bachelor's degree","56","42","14","1","1","0","2","2","0","0","0","0","7","3","4","0","0","0","32","26","6","0","0","0","1","1","0","13","9","4","-2"
"228981","Texas Lutheran University","2019","First major","'14'","Engineering","Bachelor's degree","5","5","0","0","0","0","0","0","0","0","0","0","2","2","0","0","0","0","3","3","0","0","0","0","0","0","0","0","0","0","-2"
"229018","The University of Texas Permian Basin","2019","First major","'14'","Engineering","Bachelor's degree","84","72","12","3","2","1","2","2","0","5","3","2","39","32","7","0","0","0","29","27","2","0","0","0","3","3","0","3","3","0","-2"
"229027","The University of Texas at San Antonio","2019","First major","'14'","Engineering","Bachelor's degree","456","362","94","3","1","2","41","30","11","30","24","6","223","180","43","2","0","2","112","91","21","14","12","2","5","5","0","26","19","7","-2"
"229027","The University of Texas at San Antonio","2019","First major","'14'","Engineering","Master's degree","101","78","23","0","0","0","6","4","2","3","2","1","27","21","6","0","0","0","18","15","3","4","1","3","7","6","1","36","29","7","-2"
"229027","The University of Texas at San Antonio","2019","First major","'14'","Engineering","Doctor's degree - research/scholarship","24","22","2","0","0","0","1","1","0","1","1","0","3","3","0","0","0","0","6","5","1","0","0","0","1","1","0","12","11","1","-2"
"229027","The University of Texas at San Antonio","2019","Second major","'14'","Engineering","Bachelor's degree","6","4","2","0","0","0","1","1","0","0","0","0","3","2","1","0","0","0","2","1","1","0","0","0","0","0","0","0","0","0","-2"
"229063","Texas Southern University","2019","First major","'14'","Engineering","Bachelor's degree","48","40","8","1","0","1","2","2","0","12","9","3","9","7","2","0","0","0","3","3","0","0","0","0","0","0","0","21","19","2","-2"
"229115","Texas Tech University","2019","First major","'14'","Engineering","Bachelor's degree","879","717","162","2","2","0","42","35","7","53","42","11","180","154","26","0","0","0","485","396","89","18","15","3","4","3","1","95","70","25","-2"
"229115","Texas Tech University","2019","First major","'14'","Engineering","Master's degree","138","100","38","0","0","0","1","1","0","4","4","0","15","10","5","0","0","0","52","34","18","2","2","0","0","0","0","64","49","15","-2"
"229115","Texas Tech University","2019","First major","'14'","Engineering","Doctor's degree - research/scholarship","71","61","10","1","1","0","9","7","2","2","1","1","1","1","0","0","0","0","8","6","2","2","2","0","1","1","0","47","42","5","-2"
"229115","Texas Tech University","2019","Second major","'14'","Engineering","Bachelor's degree","5","4","1","0","0","0","0","0","0","0","0","0","0","0","0","0","0","0","3","2","1","0","0","0","0","0","0","2","2","0","-2"
"229267","Trinity University","2019","First major","'14'","Engineering","Bachelor's degree","44","30","14","0","0","0","3","2","1","4","3","1","8","6","2","0","0","0","25","16","9","2","1","1","2","2","0","0","0","0","-2"
"229300","The University of Texas Health Science Center at Houston","2019","First major","'14'","Engineering","Master's degree","2","0","2","0","0","0","0","0","0","0","0","0","0","0","0","0","0","0","2","0","2","0","0","0","0","0","0","0","0","0","-2"
"229300","The University of Texas Health Science Center at Houston","2019","First major","'14'","Engineering","Doctor's degree - research/scholarship","10","4","6","0","0","0","0","0","0","0","0","0","0","0","0","0","0","0","9","3","6","0","0","0","1","1","0","0","0","0","-2"
"229355","Tyler Junior College","2019","First major","'14'","Engineering","Associate's degree","10","9","1","0","0","0","0","0","0","2","2","0","2","2","0","0","0","0","6","5","1","0","0","0","0","0","0","0","0","0","-2"
"229814","West Texas A & M University","2019","First major","'14'","Engineering","Bachelor's degree","82","64","18","0","0","0","4","3","1","0","0","0","33","26","7","1","1","0","38","30","8","3","2","1","1","0","1","2","2","0","-2"
"229814","West Texas A & M University","2019","First major","'14'","Engineering","Master's degree","1","0","1","0","0","0","0","0","0","0","0","0","0","0","0","0","0","0","1","0","1","0","0","0","0","0","0","0","0","0","-2"
"229832","Western Texas College","2019","First major","'14'","Engineering","Associate's degree","2","1","1","0","0","0","0","0","0","0","0","0","0","0","0","0","0","0","0","0","0","1","1","0","0","0","0","1","0","1","-2"
"229841","Wharton County Junior College","2019","First major","'14'","Engineering","Associate's degree","6","6","0","0","0","0","0","0","0","1","1","0","2","2","0","0","0","0","3","3","0","0","0","0","0","0","0","0","0","0","-2"
"230038","Brigham Young University-Provo","2019","First major","'14'","Engineering","Bachelor's degree","524","469","55","1","1","0","13","10","3","2","2","0","29","25","4","2","2","0","450","407","43","9","7","2","3","3","0","15","12","3","-2"
"230038","Brigham Young University-Provo","2019","First major","'14'","Engineering","Master's degree","86","75","11","0","0","0","2","1","1","0","0","0","6","6","0","0","0","0","70","62","8","2","2","0","0","0","0","6","4","2","-2"
"230038","Brigham Young University-Provo","2019","First major","'14'","Engineering","Doctor's degree - research/scholarship","24","19","5","1","1","0","2","1","1","0","0","0","1","1","0","0","0","0","14","11","3","0","0","0","0","0","0","6","5","1","-2"
"230038","Brigham Young University-Provo","2019","Second major","'14'","Engineering","Bachelor's degree","1","1","0","0","0","0","0","0","0","0","0","0","0","0","0","0","0","0","1","1","0","0","0","0","0","0","0","0","0","0","-2"
"230171","Dixie State University","2019","First major","'14'","Engineering","Associate's degree","0","0","0","0","0","0","0","0","0","0","0","0","0","0","0","0","0","0","0","0","0","0","0","0","0","0","0","0","0","0","-2"
"230171","Dixie State University","2019","First major","'14'","Engineering","Bachelor's degree","0","0","0","0","0","0","0","0","0","0","0","0","0","0","0","0","0","0","0","0","0","0","0","0","0","0","0","0","0","0","-2"
"230597","Snow College","2019","First major","'14'","Engineering","Associate's degree","18","13","5","0","0","0","0","0","0","0","0","0","0","0","0","0","0","0","16","12","4","0","0","0","0","0","0","2","1","1","-2"
"230597","Snow College","2019","First major","'14'","Engineering","Bachelor's degree","5","3","2","0","0","0","0","0","0","0","0","0","0","0","0","0","0","0","4","2","2","0","0","0","1","1","0","0","0","0","-2"
"230603","Southern Utah University","2019","First major","'14'","Engineering","Bachelor's degree","14","13","1","0","0","0","0","0","0","0","0","0","0","0","0","0","0","0","9","9","0","0","0","0","5","4","1","0","0","0","-2"
"230728","Utah State University","2019","First major","'14'","Engineering","Associate's degree","0","0","0","0","0","0","0","0","0","0","0","0","0","0","0","0","0","0","0","0","0","0","0","0","0","0","0","0","0","0","-2"
"230728","Utah State University","2019","First major","'14'","Engineering","Bachelor's degree","299","265","34","0","0","0","2","2","0","1","1","0","8","6","2","1","0","1","279","249","30","2","1","1","3","3","0","3","3","0","-2"
"230728","Utah State University","2019","First major","'14'","Engineering","Master's degree","80","64","16","0","0","0","3","2","1","1","1","0","3","2","1","0","0","0","61","50","11","1","1","0","0","0","0","11","8","3","-2"
"230728","Utah State University","2019","First major","'14'","Engineering","Doctor's degree - research/scholarship","31","26","5","0","0","0","13","11","2","1","1","0","1","1","0","0","0","0","12","11","1","0","0","0","0","0","0","4","2","2","-2"
"230737","Utah Valley University","2019","First major","'14'","Engineering","Associate's degree","30","28","2","0","0","0","0","0","0","0","0","0","6","4","2","0","0","0","24","24","0","0","0","0","0","0","0","0","0","0","-2"
"230737","Utah Valley University","2019","First major","'14'","Engineering","Bachelor's degree","38","34","4","0","0","0","1","0","1","0","0","0","4","4","0","0","0","0","26","24","2","1","0","1","2","2","0","4","4","0","-2"
"230746","Salt Lake Community College","2019","First major","'14'","Engineering","Associate's degree","57","56","1","0","0","0","3","3","0","0","0","0","6","6","0","0","0","0","44","43","1","3","3","0","0","0","0","1","1","0","-2"
"230764","University of Utah","2019","First major","'14'","Engineering","Bachelor's degree","497","389","108","0","0","0","25","18","7","1","1","0","39","34","5","2","1","1","352","279","73","24","17","7","3","3","0","51","36","15","-2"
"230764","University of Utah","2019","First major","'14'","Engineering","Master's degree","239","185","54","0","0","0","19","13","6","1","1","0","8","8","0","0","0","0","153","124","29","8","2","6","4","3","1","46","34","12","-2"
"230764","University of Utah","2019","First major","'14'","Engineering","Doctor's degree - research/scholarship","101","82","19","0","0","0","10","7","3","0","0","0","3","3","0","0","0","0","42","34","8","2","1","1","2","2","0","42","35","7","-2"
"230782","Weber State University","2019","First major","'14'","Engineering","Associate's degree","11","8","3","0","0","0","1","0","1","0","0","0","1","1","0","0","0","0","8","6","2","1","1","0","0","0","0","0","0","0","-2"
"230782","Weber State University","2019","First major","'14'","Engineering","Bachelor's degree","24","23","1","0","0","0","0","0","0","0","0","0","1","1","0","0","0","0","21","20","1","0","0","0","2","2","0","0","0","0","-2"
"230782","Weber State University","2019","First major","'14'","Engineering","Master's degree","7","7","0","0","0","0","2","2","0","0","0","0","0","0","0","0","0","0","3","3","0","0","0","0","2","2","0","0","0","0","-2"
"230995","Norwich University","2019","First major","'14'","Engineering","Bachelor's degree","56","51","5","0","0","0","1","1","0","0","0","0","3","3","0","0","0","0","45","40","5","3","3","0","4","4","0","0","0","0","-2"
"230995","Norwich University","2019","First major","'14'","Engineering","Master's degree","16","13","3","0","0","0","0","0","0","4","4","0","2","2","0","0","0","0","10","7","3","0","0","0","0","0","0","0","0","0","-2"
"230995","Norwich University","2019","Second major","'14'","Engineering","Bachelor's degree","1","1","0","0","0","0","0","0","0","0","0","0","1","1","0","0","0","0","0","0","0","0","0","0","0","0","0","0","0","0","-2"
"231059","Saint Michael's College","2019","First major","'14'","Engineering","Bachelor's degree","6","4","2","0","0","0","0","0","0","0","0","0","0","0","0","0","0","0","5","4","1","0","0","0","0","0","0","1","0","1","-2"
"231165","Vermont Technical College","2019","First major","'14'","Engineering","Associate's degree","5","4","1","0","0","0","0","0","0","0","0","0","1","1","0","0","0","0","4","3","1","0","0","0","0","0","0","0","0","0","-2"
"231165","Vermont Technical College","2019","First major","'14'","Engineering","Bachelor's degree","9","7","2","0","0","0","0","0","0","0","0","0","0","0","0","0","0","0","8","6","2","0","0","0","0","0","0","1","1","0","-2"
"231165","Vermont Technical College","2019","First major","'14'","Engineering","Master's degree","1","1","0","0","0","0","0","0","0","0","0","0","0","0","0","0","0","0","0","0","0","1","1","0","0","0","0","0","0","0","-2"
"231174","University of Vermont","2019","First major","'14'","Engineering","Bachelor's degree","200","153","47","1","1","0","6","5","1","0","0","0","8","5","3","0","0","0","157","120","37","3","0","3","4","3","1","21","19","2","-2"
"231174","University of Vermont","2019","First major","'14'","Engineering","Master's degree","23","18","5","0","0","0","0","0","0","0","0","0","1","1","0","0","0","0","17","14","3","1","1","0","1","1","0","3","1","2","-2"
"231174","University of Vermont","2019","First major","'14'","Engineering","Doctor's degree - research/scholarship","12","8","4","0","0","0","0","0","0","0","0","0","0","0","0","0","0","0","5","3","2","0","0","0","0","0","0","7","5","2","-2"
"231697","Central Virginia Community College","2019","First major","'14'","Engineering","Associate's degree","6","5","1","0","0","0","1","0","1","0","0","0","1","1","0","0","0","0","3","3","0","1","1","0","0","0","0","0","0","0","-2"
"231712","Christopher Newport University","2019","First major","'14'","Engineering","Bachelor's degree","23","21","2","0","0","0","1","1","0","4","4","0","2","2","0","0","0","0","16","14","2","0","0","0","0","0","0","0","0","0","-2"
"231712","Christopher Newport University","2019","Second major","'14'","Engineering","Bachelor's degree","1","1","0","0","0","0","0","0","0","0","0","0","0","0","0","0","0","0","1","1","0","0","0","0","0","0","0","0","0","0","-2"
"231882","Danville Community College","2019","First major","'14'","Engineering","Associate's degree","3","3","0","0","0","0","0","0","0","0","0","0","0","0","0","0","0","0","3","3","0","0","0","0","0","0","0","0","0","0","-2"
"232043","Eastern Mennonite University","2019","First major","'14'","Engineering","Bachelor's degree","1","1","0","0","0","0","0","0","0","0","0","0","0","0","0","0","0","0","1","1","0","0","0","0","0","0","0","0","0","0","-2"
"232186","George Mason University","2019","First major","'14'","Engineering","Bachelor's degree","363","274","89","0","0","0","83","56","27","27","22","5","58","44","14","1","1","0","135","104","31","15","12","3","9","8","1","35","27","8","-2"
"232186","George Mason University","2019","First major","'14'","Engineering","Master's degree","163","118","45","0","0","0","12","6","6","6","6","0","11","8","3","0","0","0","59","44","15","4","3","1","5","4","1","66","47","19","-2"
"232186","George Mason University","2019","First major","'14'","Engineering","Doctor's degree - research/scholarship","18","14","4","0","0","0","2","1","1","0","0","0","0","0","0","0","0","0","5","4","1","0","0","0","0","0","0","11","9","2","-2"
"232195","Germanna Community College","2019","First major","'14'","Engineering","Associate's degree","29","27","2","0","0","0","2","2","0","2","1","1","2","2","0","0","0","0","21","20","1","1","1","0","1","1","0","0","0","0","-2"
"232256","Hampden-Sydney College","2019","First major","'14'","Engineering","Bachelor's degree","1","1","0","0","0","0","0","0","0","0","0","0","0","0","0","0","0","0","1","1","0","0","0","0","0","0","0","0","0","0","-2"
"232256","Hampden-Sydney College","2019","Second major","'14'","Engineering","Bachelor's degree","1","1","0","0","0","0","0","0","0","0","0","0","0","0","0","0","0","0","1","1","0","0","0","0","0","0","0","0","0","0","-2"
"232265","Hampton University","2019","First major","'14'","Engineering","Bachelor's degree","7","3","4","0","0","0","0","0","0","7","3","4","0","0","0","0","0","0","0","0","0","0","0","0","0","0","0","0","0","0","-2"
"232414","J Sargeant Reynolds Community College","2019","First major","'14'","Engineering","Associate's degree","46","39","7","1","1","0","2","1","1","4","2","2","4","4","0","2","2","0","25","22","3","3","3","0","1","1","0","4","3","1","-2"
"232423","James Madison University","2019","First major","'14'","Engineering","Bachelor's degree","62","50","12","1","1","0","4","3","1","3","3","0","4","4","0","0","0","0","47","36","11","1","1","0","1","1","0","1","1","0","-2"
"232450","John Tyler Community College","2019","First major","'14'","Engineering","Associate's degree","19","18","1","0","0","0","3","3","0","2","2","0","2","2","0","0","0","0","12","11","1","0","0","0","0","0","0","0","0","0","-2"
"232557","Liberty University","2019","First major","'14'","Engineering","Bachelor's degree","78","66","12","0","0","0","1","1","0","1","0","1","4","4","0","0","0","0","43","38","5","2","1","1","17","14","3","10","8","2","-2"
"232937","Norfolk State University","2019","First major","'14'","Engineering","Bachelor's degree","19","13","6","0","0","0","0","0","0","16","11","5","1","0","1","0","0","0","0","0","0","2","2","0","0","0","0","0","0","0","-2"
"232937","Norfolk State University","2019","First major","'14'","Engineering","Master's degree","6","4","2","0","0","0","1","0","1","4","4","0","0","0","0","0","0","0","0","0","0","0","0","0","0","0","0","1","0","1","-2"
"232946","Northern Virginia Community College","2019","First major","'14'","Engineering","Associate's degree","188","159","29","0","0","0","35","29","6","19","16","3","36","28","8","1","1","0","69","62","7","6","6","0","8","6","2","14","11","3","-2"
"232982","Old Dominion University","2019","First major","'14'","Engineering","Bachelor's degree","282","233","49","1","0","1","18","13","5","40","37","3","28","22","6","5","4","1","148","126","22","19","12","7","6","4","2","17","15","2","-2"
"232982","Old Dominion University","2019","First major","'14'","Engineering","Master's degree","232","195","37","1","1","0","11","10","1","21","17","4","13","12","1","0","0","0","146","125","21","2","1","1","8","8","0","30","21","9","-2"
"232982","Old Dominion University","2019","First major","'14'","Engineering","Doctor's degree - research/scholarship","36","23","13","0","0","0","1","1","0","0","0","0","1","0","1","0","0","0","7","4","3","1","0","1","2","2","0","24","16","8","-2"
"232982","Old Dominion University","2019","First major","'14'","Engineering","Doctor's degree - professional practice","3","2","1","0","0","0","0","0","0","1","0","1","0","0","0","0","0","0","2","2","0","0","0","0","0","0","0","0","0","0","-2"
"233116","Piedmont Virginia Community College","2019","First major","'14'","Engineering","Associate's degree","20","18","2","0","0","0","1","1","0","0","0","0","0","0","0","1","1","0","17","16","1","0","0","0","0","0","0","1","0","1","-2"
"233295","Randolph-Macon College","2019","First major","'14'","Engineering","Bachelor's degree","12","3","9","0","0","0","0","0","0","1","0","1","0","0","0","0","0","0","9","2","7","0","0","0","1","1","0","1","0","1","-2"
"233295","Randolph-Macon College","2019","Second major","'14'","Engineering","Bachelor's degree","1","1","0","0","0","0","0","0","0","0","0","0","0","0","0","0","0","0","1","1","0","0","0","0","0","0","0","0","0","0","-2"
"233301","Randolph College","2019","First major","'14'","Engineering","Bachelor's degree","3","3","0","0","0","0","1","1","0","0","0","0","0","0","0","0","0","0","1","1","0","0","0","0","0","0","0","1","1","0","-2"
"233718","Sweet Briar College","2019","First major","'14'","Engineering","Bachelor's degree","2","0","2","0","0","0","0","0","0","0","0","0","0","0","0","0","0","0","2","0","2","0","0","0","0","0","0","0","0","0","-2"
"233754","Thomas Nelson Community College","2019","First major","'14'","Engineering","Associate's degree","27","21","6","0","0","0","3","1","2","3","3","0","3","2","1","0","0","0","16","14","2","2","1","1","0","0","0","0","0","0","-2"
"233772","Tidewater Community College","2019","First major","'14'","Engineering","Associate's degree","95","78","17","0","0","0","13","11","2","18","11","7","6","5","1","0","0","0","46","41","5","8","6","2","3","3","0","1","1","0","-2"
"233897","The University of Virginia's College at Wise","2019","First major","'14'","Engineering","Bachelor's degree","6","5","1","0","0","0","0","0","0","1","1","0","0","0","0","0","0","0","5","4","1","0","0","0","0","0","0","0","0","0","-2"
"233897","The University of Virginia's College at Wise","2019","Second major","'14'","Engineering","Bachelor's degree","1","1","0","0","0","0","0","0","0","0","0","0","0","0","0","0","0","0","1","1","0","0","0","0","0","0","0","0","0","0","-2"
"233921","Virginia Polytechnic Institute and State University","2019","First major","'14'","Engineering","Bachelor's degree","1639","1259","380","0","0","0","178","142","36","40","26","14","82","68","14","1","1","0","1001","754","247","69","47","22","52","35","17","216","186","30","-2"
"233921","Virginia Polytechnic Institute and State University","2019","First major","'14'","Engineering","Master's degree","432","327","105","1","1","0","26","17","9","9","6","3","12","9","3","0","0","0","161","131","30","11","7","4","6","4","2","206","152","54","-2"
"233921","Virginia Polytechnic Institute and State University","2019","First major","'14'","Engineering","Doctor's degree - research/scholarship","184","145","39","0","0","0","4","3","1","6","5","1","2","1","1","0","0","0","58","41","17","2","2","0","0","0","0","112","93","19","-2"
"233921","Virginia Polytechnic Institute and State University","2019","Second major","'14'","Engineering","Bachelor's degree","6","6","0","0","0","0","1","1","0","1","1","0","0","0","0","0","0","0","1","1","0","0","0","0","0","0","0","3","3","0","-2"
"233949","Virginia Western Community College","2019","First major","'14'","Engineering","Associate's degree","28","25","3","0","0","0","1","1","0","0","0","0","1","1","0","0","0","0","24","22","2","0","0","0","1","1","0","1","0","1","-2"
"234030","Virginia Commonwealth University","2019","First major","'14'","Engineering","Bachelor's degree","236","164","72","0","0","0","38","24","14","21","14","7","17","12","5","0","0","0","121","89","32","10","6","4","1","0","1","28","19","9","-2"
"234030","Virginia Commonwealth University","2019","First major","'14'","Engineering","Master's degree","37","32","5","0","0","0","4","4","0","1","1","0","0","0","0","0","0","0","26","23","3","1","1","0","0","0","0","5","3","2","-2"
"234030","Virginia Commonwealth University","2019","First major","'14'","Engineering","Doctor's degree - research/scholarship","26","17","9","0","0","0","1","0","1","1","0","1","0","0","0","0","0","0","8","6","2","0","0","0","0","0","0","16","11","5","-2"
"234030","Virginia Commonwealth University","2019","Second major","'14'","Engineering","Bachelor's degree","6","5","1","0","0","0","1","0","1","0","0","0","0","0","0","0","0","0","5","5","0","0","0","0","0","0","0","0","0","0","-2"
"234076","University of Virginia-Main Campus","2019","First major","'14'","Engineering","Bachelor's degree","486","320","166","0","0","0","73","46","27","17","12","5","29","19","10","0","0","0","296","202","94","25","14","11","33","18","15","13","9","4","-2"
"234076","University of Virginia-Main Campus","2019","First major","'14'","Engineering","Master's degree","163","113","50","0","0","0","10","9","1","7","4","3","12","8","4","0","0","0","61","45","16","4","2","2","2","0","2","67","45","22","-2"
"234076","University of Virginia-Main Campus","2019","First major","'14'","Engineering","Doctor's degree - research/scholarship","81","62","19","0","0","0","5","4","1","2","2","0","2","2","0","0","0","0","32","22","10","1","1","0","1","1","0","38","30","8","-2"
"234076","University of Virginia-Main Campus","2019","Second major","'14'","Engineering","Bachelor's degree","17","16","1","0","0","0","3","3","0","0","0","0","2","2","0","0","0","0","9","8","1","2","2","0","1","1","0","0","0","0","-2"
"234085","Virginia Military Institute","2019","First major","'14'","Engineering","Bachelor's degree","90","86","4","1","1","0","7","6","1","4","4","0","8","8","0","0","0","0","70","67","3","0","0","0","0","0","0","0","0","0","-2"
"234155","Virginia State University","2019","First major","'14'","Engineering","Bachelor's degree","21","14","7","0","0","0","1","1","0","20","13","7","0","0","0","0","0","0","0","0","0","0","0","0","0","0","0","0","0","0","-2"
"234207","Washington and Lee University","2019","First major","'14'","Engineering","Bachelor's degree","14","8","6","0","0","0","0","0","0","0","0","0","0","0","0","0","0","0","12","8","4","0","0","0","0","0","0","2","0","2","-2"
"234669","Bellevue College","2019","First major","'14'","Engineering","Associate's degree","33","24","9","0","0","0","3","1","2","1","0","1","3","2","1","0","0","0","16","13","3","2","1","1","3","3","0","5","4","1","-2"
"234711","Big Bend Community College","2019","First major","'14'","Engineering","Associate's degree","0","0","0","0","0","0","0","0","0","0","0","0","0","0","0","0","0","0","0","0","0","0","0","0","0","0","0","0","0","0","-2"
"234827","Central Washington University","2019","First major","'14'","Engineering","Bachelor's degree","0","0","0","0","0","0","0","0","0","0","0","0","0","0","0","0","0","0","0","0","0","0","0","0","0","0","0","0","0","0","-2"
"234845","Centralia College","2019","First major","'14'","Engineering","Associate's degree","1","1","0","0","0","0","0","0","0","0","0","0","0","0","0","0","0","0","1","1","0","0","0","0","0","0","0","0","0","0","-2"
"234933","Clark College","2019","First major","'14'","Engineering","Associate's degree","18","13","5","0","0","0","2","1","1","0","0","0","0","0","0","0","0","0","11","7","4","2","2","0","3","3","0","0","0","0","-2"
"235097","Eastern Washington University","2019","First major","'14'","Engineering","Bachelor's degree","110","100","10","1","1","0","8","8","0","1","1","0","4","3","1","0","0","0","76","67","9","1","1","0","5","5","0","14","14","0","-2"
"235103","Edmonds College","2019","First major","'14'","Engineering","Associate's degree","18","15","3","0","0","0","2","1","1","0","0","0","0","0","0","0","0","0","8","8","0","2","2","0","1","1","0","5","3","2","-2"
"235149","Everett Community College","2019","First major","'14'","Engineering","Associate's degree","51","44","7","0","0","0","7","6","1","2","2","0","3","2","1","0","0","0","20","17","3","5","4","1","6","5","1","8","8","0","-2"
"235316","Gonzaga University","2019","First major","'14'","Engineering","Bachelor's degree","172","135","37","1","1","0","11","9","2","1","0","1","13","10","3","0","0","0","123","99","24","13","8","5","9","8","1","1","0","1","-2"
"235316","Gonzaga University","2019","First major","'14'","Engineering","Master's degree","7","6","1","0","0","0","0","0","0","0","0","0","2","2","0","0","0","0","1","1","0","0","0","0","4","3","1","0","0","0","-2"
"235343","Green River College","2019","First major","'14'","Engineering","Associate's degree","36","29","7","0","0","0","2","2","0","0","0","0","4","3","1","0","0","0","13","11","2","2","0","2","3","3","0","12","10","2","-2"
"235699","Lake Washington Institute of Technology","2019","First major","'14'","Engineering","Associate's degree","6","6","0","0","0","0","0","0","0","0","0","0","0","0","0","0","0","0","3","3","0","0","0","0","3","3","0","0","0","0","-2"
"235750","Lower Columbia College","2019","First major","'14'","Engineering","Associate's degree","9","9","0","0","0","0","0","0","0","0","0","0","0","0","0","0","0","0","7","7","0","0","0","0","2","2","0","0","0","0","-2"
"236188","Olympic College","2019","First major","'14'","Engineering","Associate's degree","29","24","5","0","0","0","5","5","0","0","0","0","2","1","1","0","0","0","17","14","3","3","2","1","2","2","0","0","0","0","-2"
"236230","Pacific Lutheran University","2019","First major","'14'","Engineering","Bachelor's degree","0","0","0","0","0","0","0","0","0","0","0","0","0","0","0","0","0","0","0","0","0","0","0","0","0","0","0","0","0","0","-2"
"236452","Saint Martin's University","2019","First major","'14'","Engineering","Bachelor's degree","45","39","6","1","1","0","3","2","1","0","0","0","6","5","1","2","2","0","24","20","4","4","4","0","2","2","0","3","3","0","-2"
"236452","Saint Martin's University","2019","First major","'14'","Engineering","Master's degree","5","4","1","0","0","0","0","0","0","0","0","0","0","0","0","0","0","0","5","4","1","0","0","0","0","0","0","0","0","0","-2"
"236504","South Seattle College","2019","First major","'14'","Engineering","Associate's degree","0","0","0","0","0","0","0","0","0","0","0","0","0","0","0","0","0","0","0","0","0","0","0","0","0","0","0","0","0","0","-2"
"236577","Seattle Pacific University","2019","First major","'14'","Engineering","Bachelor's degree","43","30","13","0","0","0","7","3","4","0","0","0","2","1","1","0","0","0","26","19","7","1","1","0","0","0","0","7","6","1","-2"
"236595","Seattle University","2019","First major","'14'","Engineering","Bachelor's degree","88","71","17","0","0","0","14","10","4","3","2","1","5","4","1","0","0","0","25","19","6","6","6","0","19","17","2","16","13","3","-2"
"236595","Seattle University","2019","First major","'14'","Engineering","Master's degree","8","4","4","0","0","0","2","1","1","0","0","0","0","0","0","0","0","0","4","2","2","1","0","1","0","0","0","1","1","0","-2"
"236610","Shoreline Community College","2019","First major","'14'","Engineering","Associate's degree","9","7","2","0","0","0","1","0","1","0","0","0","0","0","0","0","0","0","2","2","0","1","1","0","1","1","0","4","3","1","-2"
"236708","Spokane Falls Community College","2019","First major","'14'","Engineering","Associate's degree","14","13","1","0","0","0","1","1","0","0","0","0","0","0","0","0","0","0","9","8","1","1","1","0","1","1","0","2","2","0","-2"
"236753","Tacoma Community College","2019","First major","'14'","Engineering","Associate's degree","42","28","14","0","0","0","7","3","4","1","1","0","0","0","0","1","1","0","20","14","6","2","1","1","1","1","0","10","7","3","-2"
"236887","Walla Walla Community College","2019","First major","'14'","Engineering","Associate's degree","0","0","0","0","0","0","0","0","0","0","0","0","0","0","0","0","0","0","0","0","0","0","0","0","0","0","0","0","0","0","-2"
"236896","Walla Walla University","2019","First major","'14'","Engineering","Bachelor's degree","47","37","10","0","0","0","1","1","0","1","1","0","5","2","3","0","0","0","38","31","7","0","0","0","1","1","0","1","1","0","-2"
"236939","Washington State University","2019","First major","'14'","Engineering","Bachelor's degree","667","561","106","2","2","0","57","46","11","6","5","1","61","50","11","2","1","1","434","367","67","35","27","8","18","17","1","52","46","6","-2"
"236939","Washington State University","2019","First major","'14'","Engineering","Master's degree","85","62","23","1","0","1","6","5","1","2","2","0","2","2","0","0","0","0","34","25","9","0","0","0","1","1","0","39","27","12","-2"
"236939","Washington State University","2019","First major","'14'","Engineering","Doctor's degree - research/scholarship","56","41","15","1","1","0","2","0","2","2","2","0","0","0","0","0","0","0","4","2","2","0","0","0","1","0","1","46","36","10","-2"
"236948","University of Washington-Seattle Campus","2019","First major","'14'","Engineering","Bachelor's degree","911","665","246","3","2","1","213","151","62","26","23","3","40","30","10","2","1","1","381","280","101","69","52","17","10","8","2","167","118","49","-2"
"236948","University of Washington-Seattle Campus","2019","First major","'14'","Engineering","Master's degree","506","369","137","1","1","0","59","39","20","9","8","1","29","21","8","1","1","0","198","150","48","20","12","8","6","2","4","183","135","48","-2"
"236948","University of Washington-Seattle Campus","2019","First major","'14'","Engineering","Doctor's degree - research/scholarship","142","95","47","0","0","0","9","8","1","0","0","0","8","6","2","0","0","0","54","39","15","4","2","2","4","0","4","63","40","23","-2"
"237011","Western Washington University","2019","First major","'14'","Engineering","Bachelor's degree","67","57","10","0","0","0","4","4","0","0","0","0","5","4","1","0","0","0","50","42","8","7","6","1","0","0","0","1","1","0","-2"
"237039","Whatcom Community College","2019","First major","'14'","Engineering","Associate's degree","11","10","1","0","0","0","0","0","0","0","0","0","1","1","0","0","0","0","4","4","0","0","0","0","0","0","0","6","5","1","-2"
"237057","Whitman College","2019","First major","'14'","Engineering","Bachelor's degree","2","2","0","0","0","0","1","1","0","0","0","0","0","0","0","0","0","0","1","1","0","0","0","0","0","0","0","0","0","0","-2"
"237525","Marshall University","2019","First major","'14'","Engineering","Bachelor's degree","63","53","10","0","0","0","0","0","0","3","3","0","1","1","0","0","0","0","57","48","9","1","1","0","0","0","0","1","0","1","-2"
"237525","Marshall University","2019","First major","'14'","Engineering","Master's degree","46","42","4","0","0","0","0","0","0","0","0","0","0","0","0","0","0","0","15","15","0","0","0","0","0","0","0","31","27","4","-2"
"237701","Potomac State College of West Virginia University","2019","First major","'14'","Engineering","Associate's degree","12","11","1","0","0","0","0","0","0","0","0","0","2","2","0","0","0","0","10","9","1","0","0","0","0","0","0","0","0","0","-2"
"237792","Shepherd University","2019","First major","'14'","Engineering","Bachelor's degree","6","6","0","0","0","0","0","0","0","0","0","0","1","1","0","0","0","0","5","5","0","0","0","0","0","0","0","0","0","0","-2"
"237792","Shepherd University","2019","Second major","'14'","Engineering","Bachelor's degree","1","0","1","0","0","0","0","0","0","0","0","0","0","0","0","0","0","0","1","0","1","0","0","0","0","0","0","0","0","0","-2"
"237899","West Virginia State University","2019","First major","'14'","Engineering","Bachelor's degree","0","0","0","0","0","0","0","0","0","0","0","0","0","0","0","0","0","0","0","0","0","0","0","0","0","0","0","0","0","0","-2"
"237950","West Virginia University Institute of Technology","2019","First major","'14'","Engineering","Bachelor's degree","51","42","9","1","1","0","1","0","1","2","2","0","3","3","0","0","0","0","34","27","7","1","1","0","0","0","0","9","8","1","-2"
"238032","West Virginia University","2019","First major","'14'","Engineering","Bachelor's degree","790","659","131","1","0","1","15","11","4","15","12","3","16","13","3","2","2","0","560","458","102","12","9","3","0","0","0","169","154","15","-2"
"238032","West Virginia University","2019","First major","'14'","Engineering","Master's degree","98","86","12","0","0","0","2","2","0","8","6","2","0","0","0","0","0","0","43","38","5","2","2","0","0","0","0","43","38","5","-2"
"238032","West Virginia University","2019","First major","'14'","Engineering","Doctor's degree - research/scholarship","28","23","5","0","0","0","2","2","0","1","1","0","0","0","0","0","0","0","7","6","1","1","1","0","0","0","0","17","13","4","-2"
"238078","Wheeling University","2019","First major","'14'","Engineering","Bachelor's degree","7","6","1","0","0","0","0","0","0","2","1","1","0","0","0","0","0","0","2","2","0","0","0","0","1","1","0","2","2","0","-2"
"238333","Beloit College","2019","First major","'14'","Engineering","Bachelor's degree","0","0","0","0","0","0","0","0","0","0","0","0","0","0","0","0","0","0","0","0","0","0","0","0","0","0","0","0","0","0","-2"
"238458","Carroll University","2019","First major","'14'","Engineering","Bachelor's degree","0","0","0","0","0","0","0","0","0","0","0","0","0","0","0","0","0","0","0","0","0","0","0","0","0","0","0","0","0","0","-2"
"238458","Carroll University","2019","First major","'14'","Engineering","Master's degree","5","4","1","0","0","0","0","0","0","0","0","0","0","0","0","0","0","0","3","3","0","0","0","0","1","0","1","1","1","0","-2"
"238759","Gateway Technical College","2019","First major","'14'","Engineering","Associate's degree","6","3","3","0","0","0","1","1","0","0","0","0","0","0","0","0","0","0","5","2","3","0","0","0","0","0","0","0","0","0","-2"
"239105","Marquette University","2019","First major","'14'","Engineering","Bachelor's degree","239","173","66","0","0","0","12","9","3","4","4","0","14","10","4","0","0","0","195","141","54","12","8","4","0","0","0","2","1","1","-2"
"239105","Marquette University","2019","First major","'14'","Engineering","Master's degree","44","39","5","0","0","0","1","1","0","0","0","0","1","0","1","0","0","0","26","23","3","0","0","0","3","2","1","13","13","0","-2"
"239105","Marquette University","2019","First major","'14'","Engineering","Doctor's degree - research/scholarship","12","10","2","0","0","0","1","0","1","0","0","0","0","0","0","0","0","0","8","7","1","0","0","0","1","1","0","2","2","0","-2"
"239169","Medical College of Wisconsin","2019","First major","'14'","Engineering","Master's degree","3","3","0","0","0","0","0","0","0","0","0","0","0","0","0","0","0","0","0","0","0","0","0","0","2","2","0","1","1","0","-2"
"239169","Medical College of Wisconsin","2019","First major","'14'","Engineering","Doctor's degree - research/scholarship","1","0","1","0","0","0","0","0","0","0","0","0","0","0","0","0","0","0","0","0","0","0","0","0","0","0","0","1","0","1","-2"
"239318","Milwaukee School of Engineering","2019","First major","'14'","Engineering","Bachelor's degree","431","342","89","1","1","0","15","10","5","6","4","2","12","7","5","0","0","0","280","222","58","11","7","4","44","36","8","62","55","7","-2"
"239318","Milwaukee School of Engineering","2019","First major","'14'","Engineering","Master's degree","29","24","5","0","0","0","0","0","0","1","1","0","0","0","0","0","0","0","21","18","3","0","0","0","1","1","0","6","4","2","-2"
"239488","Northeast Wisconsin Technical College","2019","First major","'14'","Engineering","Associate's degree","0","0","0","0","0","0","0","0","0","0","0","0","0","0","0","0","0","0","0","0","0","0","0","0","0","0","0","0","0","0","-2"
"239512","Northland College","2019","First major","'14'","Engineering","Bachelor's degree","0","0","0","0","0","0","0","0","0","0","0","0","0","0","0","0","0","0","0","0","0","0","0","0","0","0","0","0","0","0","-2"
"240107","Viterbo University","2019","First major","'14'","Engineering","Bachelor's degree","0","0","0","0","0","0","0","0","0","0","0","0","0","0","0","0","0","0","0","0","0","0","0","0","0","0","0","0","0","0","-2"
"240268","University of Wisconsin-Eau Claire","2019","First major","'14'","Engineering","Bachelor's degree","4","2","2","0","0","0","0","0","0","0","0","0","0","0","0","0","0","0","4","2","2","0","0","0","0","0","0","0","0","0","-2"
"240329","University of Wisconsin-La Crosse","2019","First major","'14'","Engineering","Master's degree","13","11","2","0","0","0","0","0","0","0","0","0","0","0","0","0","0","0","5","4","1","0","0","0","0","0","0","8","7","1","-2"
"240417","University of Wisconsin-Stout","2019","First major","'14'","Engineering","Bachelor's degree","111","98","13","0","0","0","0","0","0","1","1","0","2","2","0","1","1","0","102","89","13","1","1","0","0","0","0","4","4","0","-2"
"240417","University of Wisconsin-Stout","2019","First major","'14'","Engineering","Master's degree","19","16","3","0","0","0","4","2","2","2","2","0","0","0","0","0","0","0","12","11","1","0","0","0","0","0","0","1","1","0","-2"
"240417","University of Wisconsin-Stout","2019","Second major","'14'","Engineering","Bachelor's degree","1","1","0","0","0","0","0","0","0","0","0","0","0","0","0","0","0","0","1","1","0","0","0","0","0","0","0","0","0","0","-2"
"240444","University of Wisconsin-Madison","2019","First major","'14'","Engineering","Bachelor's degree","1013","776","237","2","1","1","59","47","12","13","11","2","43","33","10","1","1","0","751","571","180","23","20","3","7","6","1","114","86","28","-2"
"240444","University of Wisconsin-Madison","2019","First major","'14'","Engineering","Master's degree","365","271","94","0","0","0","11","7","4","5","4","1","10","8","2","0","0","0","187","139","48","5","3","2","8","7","1","139","103","36","-2"
"240444","University of Wisconsin-Madison","2019","First major","'14'","Engineering","Doctor's degree - research/scholarship","144","112","32","0","0","0","5","4","1","3","1","2","7","4","3","0","0","0","43","38","5","1","1","0","6","3","3","79","61","18","-2"
"240444","University of Wisconsin-Madison","2019","Second major","'14'","Engineering","Bachelor's degree","43","38","5","0","0","0","2","2","0","0","0","0","0","0","0","0","0","0","28","25","3","1","1","0","0","0","0","12","10","2","-2"
"240444","University of Wisconsin-Madison","2019","Second major","'14'","Engineering","Master's degree","1","1","0","0","0","0","0","0","0","0","0","0","0","0","0","0","0","0","0","0","0","0","0","0","0","0","0","1","1","0","-2"
"240453","University of Wisconsin-Milwaukee","2019","First major","'14'","Engineering","Bachelor's degree","281","244","37","0","0","0","14","11","3","7","6","1","19","16","3","0","0","0","208","181","27","7","7","0","0","0","0","26","23","3","-2"
"240453","University of Wisconsin-Milwaukee","2019","First major","'14'","Engineering","Master's degree","83","64","19","0","0","0","5","3","2","0","0","0","1","1","0","0","0","0","18","17","1","0","0","0","0","0","0","59","43","16","-2"
"240453","University of Wisconsin-Milwaukee","2019","First major","'14'","Engineering","Doctor's degree - research/scholarship","28","22","6","0","0","0","0","0","0","0","0","0","0","0","0","0","0","0","4","4","0","0","0","0","1","0","1","23","18","5","-2"
"240453","University of Wisconsin-Milwaukee","2019","Second major","'14'","Engineering","Bachelor's degree","1","1","0","0","0","0","0","0","0","0","0","0","0","0","0","0","0","0","1","1","0","0","0","0","0","0","0","0","0","0","-2"
"240462","University of Wisconsin-Platteville","2019","First major","'14'","Engineering","Bachelor's degree","485","412","73","0","0","0","9","7","2","1","1","0","16","14","2","0","0","0","434","371","63","9","5","4","1","1","0","15","13","2","-2"
"240462","University of Wisconsin-Platteville","2019","First major","'14'","Engineering","Master's degree","53","41","12","0","0","0","2","2","0","3","2","1","1","1","0","0","0","0","42","31","11","0","0","0","4","4","0","1","1","0","-2"
"240462","University of Wisconsin-Platteville","2019","Second major","'14'","Engineering","Bachelor's degree","6","4","2","0","0","0","0","0","0","0","0","0","0","0","0","0","0","0","6","4","2","0","0","0","0","0","0","0","0","0","-2"
"240471","University of Wisconsin-River Falls","2019","First major","'14'","Engineering","Bachelor's degree","1","0","1","0","0","0","0","0","0","0","0","0","0","0","0","0","0","0","1","0","1","0","0","0","0","0","0","0","0","0","-2"
"240480","University of Wisconsin-Stevens Point","2019","First major","'14'","Engineering","Bachelor's degree","16","15","1","0","0","0","0","0","0","0","0","0","0","0","0","0","0","0","16","15","1","0","0","0","0","0","0","0","0","0","-2"
"240480","University of Wisconsin-Stevens Point","2019","Second major","'14'","Engineering","Bachelor's degree","13","12","1","0","0","0","0","0","0","0","0","0","0","0","0","0","0","0","13","12","1","0","0","0","0","0","0","0","0","0","-2"
"240505","Casper College","2019","First major","'14'","Engineering","Associate's degree","7","7","0","0","0","0","0","0","0","0","0","0","0","0","0","0","0","0","7","7","0","0","0","0","0","0","0","0","0","0","-2"
"240514","Central Wyoming College","2019","First major","'14'","Engineering","Associate's degree","2","0","2","0","0","0","0","0","0","0","0","0","0","0","0","0","0","0","2","0","2","0","0","0","0","0","0","0","0","0","-2"
"240620","Laramie County Community College","2019","First major","'14'","Engineering","Associate's degree","3","2","1","0","0","0","0","0","0","0","0","0","0","0","0","0","0","0","3","2","1","0","0","0","0","0","0","0","0","0","-2"
"240657","Northwest College","2019","First major","'14'","Engineering","Associate's degree","7","6","1","0","0","0","0","0","0","0","0","0","0","0","0","0","0","0","6","5","1","0","0","0","0","0","0","1","1","0","-2"
"240666","Northern Wyoming Community College District","2019","First major","'14'","Engineering","Associate's degree","7","5","2","0","0","0","0","0","0","0","0","0","0","0","0","0","0","0","6","4","2","1","1","0","0","0","0","0","0","0","-2"
"240693","Western Wyoming Community College","2019","First major","'14'","Engineering","Associate's degree","7","5","2","0","0","0","0","0","0","0","0","0","0","0","0","0","0","0","4","4","0","2","1","1","0","0","0","1","0","1","-2"
"240727","University of Wyoming","2019","First major","'14'","Engineering","Bachelor's degree","306","250","56","0","0","0","3","1","2","1","1","0","14","13","1","1","1","0","182","146","36","9","8","1","17","17","0","79","63","16","-2"
"240727","University of Wyoming","2019","First major","'14'","Engineering","Master's degree","36","27","9","0","0","0","1","1","0","0","0","0","0","0","0","0","0","0","24","19","5","0","0","0","0","0","0","11","7","4","-2"
"240727","University of Wyoming","2019","First major","'14'","Engineering","Doctor's degree - research/scholarship","20","12","8","0","0","0","0","0","0","0","0","0","0","0","0","0","0","0","4","2","2","0","0","0","0","0","0","16","10","6","-2"
"240727","University of Wyoming","2019","Second major","'14'","Engineering","Bachelor's degree","2","2","0","0","0","0","0","0","0","0","0","0","1","1","0","0","0","0","1","1","0","0","0","0","0","0","0","0","0","0","-2"
"240736","American Samoa Community College","2019","First major","'14'","Engineering","Associate's degree","1","1","0","0","0","0","0","0","0","0","0","0","0","0","0","1","1","0","0","0","0","0","0","0","0","0","0","0","0","0","-2"
"241377","Caribbean University-Bayamon","2019","First major","'14'","Engineering","Bachelor's degree","5","5","0","0","0","0","0","0","0","0","0","0","5","5","0","0","0","0","0","0","0","0","0","0","0","0","0","0","0","0","-2"
"242121","Humacao Community College","2019","First major","'14'","Engineering","Associate's degree","13","13","0","0","0","0","0","0","0","0","0","0","13","13","0","0","0","0","0","0","0","0","0","0","0","0","0","0","0","0","-2"
"242705","Inter American University of Puerto Rico-Bayamon","2019","First major","'14'","Engineering","Bachelor's degree","52","46","6","1","1","0","0","0","0","0","0","0","51","45","6","0","0","0","0","0","0","0","0","0","0","0","0","0","0","0","-2"
"243197","University of Puerto Rico-Mayaguez","2019","First major","'14'","Engineering","Bachelor's degree","428","313","115","0","0","0","0","0","0","0","0","0","408","301","107","0","0","0","0","0","0","0","0","0","20","12","8","0","0","0","-2"
"243197","University of Puerto Rico-Mayaguez","2019","First major","'14'","Engineering","Master's degree","61","36","25","0","0","0","0","0","0","0","0","0","37","21","16","0","0","0","0","0","0","0","0","0","5","4","1","19","11","8","-2"
"243197","University of Puerto Rico-Mayaguez","2019","First major","'14'","Engineering","Doctor's degree - research/scholarship","8","8","0","0","0","0","0","0","0","0","0","0","2","2","0","0","0","0","0","0","0","0","0","0","0","0","0","6","6","0","-2"
"243577","Universidad Politecnica de Puerto Rico","2019","First major","'14'","Engineering","Associate's degree","1","1","0","0","0","0","0","0","0","0","0","0","1","1","0","0","0","0","0","0","0","0","0","0","0","0","0","0","0","0","-2"
"243577","Universidad Politecnica de Puerto Rico","2019","First major","'14'","Engineering","Bachelor's degree","295","233","62","0","0","0","0","0","0","0","0","0","292","231","61","0","0","0","2","1","1","0","0","0","1","1","0","0","0","0","-2"
"243577","Universidad Politecnica de Puerto Rico","2019","First major","'14'","Engineering","Master's degree","56","40","16","0","0","0","0","0","0","0","0","0","56","40","16","0","0","0","0","0","0","0","0","0","0","0","0","0","0","0","-2"
"243577","Universidad Politecnica de Puerto Rico","2019","First major","'14'","Engineering","Doctor's degree - other","2","2","0","0","0","0","0","0","0","0","0","0","2","2","0","0","0","0","0","0","0","0","0","0","0","0","0","0","0","0","-2"
"243601","Universidad Ana G. Mendez-Gurabo Campus","2019","First major","'14'","Engineering","Bachelor's degree","126","115","11","0","0","0","0","0","0","0","0","0","126","115","11","0","0","0","0","0","0","0","0","0","0","0","0","0","0","0","-2"
"243601","Universidad Ana G. Mendez-Gurabo Campus","2019","First major","'14'","Engineering","Master's degree","8","7","1","0","0","0","0","0","0","0","0","0","8","7","1","0","0","0","0","0","0","0","0","0","0","0","0","0","0","0","-2"
"243744","Stanford University","2019","First major","'14'","Engineering","Bachelor's degree","356","195","161","1","1","0","73","41","32","20","10","10","71","40","31","1","1","0","114","59","55","38","24","14","3","2","1","35","17","18","-2"
"243744","Stanford University","2019","First major","'14'","Engineering","Master's degree","723","478","245","0","0","0","129","78","51","9","4","5","49","39","10","0","0","0","220","153","67","37","28","9","4","4","0","275","172","103","-2"
"243744","Stanford University","2019","First major","'14'","Engineering","Doctor's degree - research/scholarship","254","168","86","1","0","1","38","22","16","3","2","1","15","11","4","0","0","0","81","53","28","8","3","5","0","0","0","108","77","31","-2"
"243744","Stanford University","2019","Second major","'14'","Engineering","Bachelor's degree","4","1","3","0","0","0","1","0","1","0","0","0","1","0","1","0","0","0","2","1","1","0","0","0","0","0","0","0","0","0","-2"
"243780","Purdue University-Main Campus","2019","First major","'14'","Engineering","Bachelor's degree","1928","1419","509","0","0","0","209","147","62","27","20","7","72","54","18","2","2","0","1077","788","289","48","32","16","62","35","27","431","341","90","-2"
"243780","Purdue University-Main Campus","2019","First major","'14'","Engineering","Master's degree","667","514","153","1","1","0","42","32","10","9","4","5","21","18","3","0","0","0","239","186","53","10","8","2","3","2","1","342","263","79","-2"
"243780","Purdue University-Main Campus","2019","First major","'14'","Engineering","Doctor's degree - research/scholarship","281","221","60","0","0","0","11","6","5","4","3","1","5","3","2","1","1","0","60","46","14","3","2","1","5","3","2","192","157","35","-2"
"246354","Palo Alto College","2019","First major","'14'","Engineering","Associate's degree","9","7","2","0","0","0","0","0","0","0","0","0","8","6","2","0","0","0","1","1","0","0","0","0","0","0","0","0","0","0","-2"
"247834","Collin County Community College District","2019","First major","'14'","Engineering","Associate's degree","16","14","2","0","0","0","2","2","0","1","1","0","3","2","1","0","0","0","7","7","0","2","2","0","0","0","0","1","0","1","-2"
"262031","St Charles Community College","2019","First major","'14'","Engineering","Associate's degree","24","23","1","0","0","0","0","0","0","2","2","0","1","1","0","0","0","0","16","15","1","1","1","0","3","3","0","1","1","0","-2"
"363633","Luna Community College","2019","First major","'14'","Engineering","Associate's degree","2","2","0","0","0","0","0","0","0","1","1","0","0","0","0","0","0","0","1","1","0","0","0","0","0","0","0","0","0","0","-2"
"363907","Caribbean University-Ponce","2019","First major","'14'","Engineering","Bachelor's degree","25","18","7","0","0","0","0","0","0","0","0","0","25","18","7","0","0","0","0","0","0","0","0","0","0","0","0","0","0","0","-2"
"363934","University of Advancing Technology","2019","First major","'14'","Engineering","Associate's degree","2","2","0","0","0","0","0","0","0","1","1","0","0","0","0","0","0","0","0","0","0","0","0","0","1","1","0","0","0","0","-2"
"363934","University of Advancing Technology","2019","First major","'14'","Engineering","Bachelor's degree","5","5","0","0","0","0","0","0","0","0","0","0","0","0","0","0","0","0","2","2","0","3","3","0","0","0","0","0","0","0","-2"
"366252","Pennsylvania College of Technology","2019","First major","'14'","Engineering","Associate's degree","30","30","0","0","0","0","0","0","0","0","0","0","1","1","0","0","0","0","27","27","0","2","2","0","0","0","0","0","0","0","-2"
"366252","Pennsylvania College of Technology","2019","First major","'14'","Engineering","Bachelor's degree","27","25","2","0","0","0","0","0","0","1","1","0","0","0","0","0","0","0","23","21","2","0","0","0","0","0","0","3","3","0","-2"
"366395","Suffolk County Community College","2019","First major","'14'","Engineering","Associate's degree","26","24","2","0","0","0","1","1","0","4","3","1","5","5","0","0","0","0","15","14","1","0","0","0","1","1","0","0","0","0","-2"
"366401","Las Positas College","2019","First major","'14'","Engineering","Associate's degree","0","0","0","0","0","0","0","0","0","0","0","0","0","0","0","0","0","0","0","0","0","0","0","0","0","0","0","0","0","0","-2"
"377555","University of Washington-Bothell Campus","2019","First major","'14'","Engineering","Bachelor's degree","120","102","18","0","0","0","31","27","4","5","5","0","6","6","0","2","2","0","47","38","9","10","8","2","1","1","0","18","15","3","-2"
"377555","University of Washington-Bothell Campus","2019","First major","'14'","Engineering","Master's degree","21","18","3","0","0","0","2","2","0","2","2","0","2","2","0","1","0","1","8","6","2","0","0","0","3","3","0","3","3","0","-2"
"377564","University of Washington-Tacoma Campus","2019","First major","'14'","Engineering","Bachelor's degree","18","17","1","0","0","0","5","4","1","2","2","0","2","2","0","0","0","0","8","8","0","1","1","0","0","0","0","0","0","0","-2"
"384342","Heartland Community College","2019","First major","'14'","Engineering","Associate's degree","4","3","1","0","0","0","0","0","0","0","0","0","0","0","0","0","0","0","4","3","1","0","0","0","0","0","0","0","0","0","-2"
"399869","Southern California Institute of Technology","2019","First major","'14'","Engineering","Bachelor's degree","81","73","8","0","0","0","12","10","2","6","6","0","35","31","4","2","2","0","22","20","2","2","2","0","2","2","0","0","0","0","-2"
"405872","Carroll Community College","2019","First major","'14'","Engineering","Associate's degree","2","2","0","0","0","0","0","0","0","0","0","0","0","0","0","0","0","0","2","2","0","0","0","0","0","0","0","0","0","0","-2"
"409315","South Texas College","2019","First major","'14'","Engineering","Associate's degree","95","77","18","0","0","0","0","0","0","0","0","0","74","60","14","0","0","0","3","3","0","0","0","0","1","0","1","17","14","3","-2"
"413617","College of Menominee Nation","2019","First major","'14'","Engineering","Associate's degree","0","0","0","0","0","0","0","0","0","0","0","0","0","0","0","0","0","0","0","0","0","0","0","0","0","0","0","0","0","0","-2"
"420398","Northwest Vista College","2019","First major","'14'","Engineering","Associate's degree","28","28","0","0","0","0","4","4","0","1","1","0","15","15","0","1","1","0","7","7","0","0","0","0","0","0","0","0","0","0","-2"
"420574","Arizona State University-Polytechnic","2019","First major","'14'","Engineering","Bachelor's degree","321","275","46","2","2","0","17","12","5","9","7","2","59","46","13","1","1","0","184","163","21","20","16","4","0","0","0","29","28","1","-2"
"420574","Arizona State University-Polytechnic","2019","First major","'14'","Engineering","Master's degree","169","117","52","0","0","0","6","5","1","1","0","1","7","4","3","0","0","0","35","29","6","2","1","1","0","0","0","118","78","40","-2"
"420574","Arizona State University-Polytechnic","2019","First major","'14'","Engineering","Doctor's degree - research/scholarship","1","1","0","0","0","0","0","0","0","0","0","0","0","0","0","0","0","0","0","0","0","0","0","0","0","0","0","1","1","0","-2"
"426314","Embry-Riddle Aeronautical University-Worldwide","2019","First major","'14'","Engineering","Associate's degree","13","12","1","0","0","0","1","1","0","1","0","1","1","1","0","0","0","0","9","9","0","1","1","0","0","0","0","0","0","0","-2"
"426314","Embry-Riddle Aeronautical University-Worldwide","2019","First major","'14'","Engineering","Bachelor's degree","0","0","0","0","0","0","0","0","0","0","0","0","0","0","0","0","0","0","0","0","0","0","0","0","0","0","0","0","0","0","-2"
"426314","Embry-Riddle Aeronautical University-Worldwide","2019","First major","'14'","Engineering","Master's degree","97","76","21","0","0","0","3","3","0","12","9","3","11","9","2","0","0","0","52","41","11","5","4","1","11","7","4","3","3","0","-2"
"433660","Florida Gulf Coast University","2019","First major","'14'","Engineering","Bachelor's degree","143","102","41","0","0","0","6","5","1","10","8","2","32","21","11","0","0","0","80","56","24","1","1","0","6","6","0","8","5","3","-2"
"433660","Florida Gulf Coast University","2019","First major","'14'","Engineering","Master's degree","8","5","3","0","0","0","0","0","0","0","0","0","0","0","0","0","0","0","8","5","3","0","0","0","0","0","0","0","0","0","-2"
"433660","Florida Gulf Coast University","2019","Second major","'14'","Engineering","Bachelor's degree","1","0","1","0","0","0","1","0","1","0","0","0","0","0","0","0","0","0","0","0","0","0","0","0","0","0","0","0","0","0","-2"
"434672","Community College of Baltimore County","2019","First major","'14'","Engineering","Associate's degree","18","12","6","0","0","0","6","3","3","2","1","1","0","0","0","0","0","0","8","7","1","1","1","0","0","0","0","1","0","1","-2"
"437103","Baton Rouge Community College","2019","First major","'14'","Engineering","Associate's degree","8","6","2","0","0","0","0","0","0","1","1","0","1","1","0","0","0","0","2","2","0","0","0","0","3","1","2","1","1","0","-2"
"438498","Stratford University","2019","First major","'14'","Engineering","Master's degree","9","7","2","1","1","0","0","0","0","2","1","1","0","0","0","0","0","0","1","1","0","0","0","0","0","0","0","5","4","1","-2"
"439190","Cascadia College","2019","First major","'14'","Engineering","Associate's degree","4","2","2","0","0","0","1","0","1","0","0","0","0","0","0","0","0","0","0","0","0","3","2","1","0","0","0","0","0","0","-2"
"440031","Keck Graduate Institute","2019","First major","'14'","Engineering","Master's degree","23","10","13","0","0","0","4","1","3","1","0","1","7","4","3","1","1","0","5","1","4","0","0","0","0","0","0","5","3","2","-2"
"441982","Franklin W Olin College of Engineering","2019","First major","'14'","Engineering","Bachelor's degree","78","35","43","0","0","0","14","8","6","0","0","0","6","2","4","0","0","0","33","12","21","8","4","4","10","5","5","7","4","3","-2"
"443128","International Technological University","2019","First major","'14'","Engineering","Master's degree","98","52","46","0","0","0","0","0","0","0","0","0","0","0","0","0","0","0","0","0","0","0","0","0","0","0","0","98","52","46","-2"
"443128","International Technological University","2019","First major","'14'","Engineering","Doctor's degree - research/scholarship","0","0","0","0","0","0","0","0","0","0","0","0","0","0","0","0","0","0","0","0","0","0","0","0","0","0","0","0","0","0","-2"
"443410","DigiPen Institute of Technology","2019","First major","'14'","Engineering","Bachelor's degree","10","8","2","0","0","0","0","0","0","0","0","0","0","0","0","0","0","0","2","2","0","2","1","1","6","5","1","0","0","0","-2"
"443562","Dewey University-Hato Rey","2019","First major","'14'","Engineering","Associate's degree","0","0","0","0","0","0","0","0","0","0","0","0","0","0","0","0","0","0","0","0","0","0","0","0","0","0","0","0","0","0","-2"
"445188","University of California-Merced","2019","First major","'14'","Engineering","Bachelor's degree","296","233","63","0","0","0","84","63","21","7","6","1","112","85","27","4","3","1","59","52","7","16","11","5","2","2","0","12","11","1","-2"
"445188","University of California-Merced","2019","First major","'14'","Engineering","Master's degree","25","17","8","0","0","0","3","2","1","0","0","0","3","2","1","0","0","0","1","1","0","0","0","0","0","0","0","18","12","6","-2"
"445188","University of California-Merced","2019","First major","'14'","Engineering","Doctor's degree - research/scholarship","13","10","3","0","0","0","1","0","1","0","0","0","1","1","0","0","0","0","1","1","0","0","0","0","0","0","0","10","8","2","-2"
"445188","University of California-Merced","2019","Second major","'14'","Engineering","Bachelor's degree","1","1","0","0","0","0","0","0","0","1","1","0","0","0","0","0","0","0","0","0","0","0","0","0","0","0","0","0","0","0","-2"
"446552","Southern Technical College","2019","First major","'14'","Engineering","Associate's degree","33","31","2","0","0","0","0","0","0","14","13","1","8","8","0","0","0","0","9","8","1","2","2","0","0","0","0","0","0","0","-2"
"448594","West Hills College-Lemoore","2019","First major","'14'","Engineering","Associate's degree","6","5","1","0","0","0","1","1","0","0","0","0","3","2","1","0","0","0","2","2","0","0","0","0","0","0","0","0","0","0","-2"
"448673","Rasmussen University-Illinois","2019","First major","'14'","Engineering","Associate's degree","3","2","1","0","0","0","0","0","0","0","0","0","0","0","0","0","0","0","3","2","1","0","0","0","0","0","0","0","0","0","-2"
"449339","American Public University System","2019","First major","'14'","Engineering","Bachelor's degree","10","10","0","0","0","0","0","0","0","0","0","0","0","0","0","0","0","0","10","10","0","0","0","0","0","0","0","0","0","0","-2"
"450571","Rasmussen University-Wisconsin","2019","First major","'14'","Engineering","Associate's degree","1","1","0","0","0","0","0","0","0","0","0","0","0","0","0","0","0","0","1","1","0","0","0","0","0","0","0","0","0","0","-2"
"455114","College of Western Idaho","2019","First major","'14'","Engineering","Associate's degree","2","2","0","0","0","0","0","0","0","0","0","0","1","1","0","0","0","0","0","0","0","0","0","0","0","0","0","1","1","0","-2"
"456481","Polytechnic University of Puerto Rico-Miami","2019","First major","'14'","Engineering","Master's degree","13","10","3","0","0","0","0","0","0","0","0","0","13","10","3","0","0","0","0","0","0","0","0","0","0","0","0","0","0","0","-2"
"456490","Polytechnic University of Puerto Rico-Orlando","2019","First major","'14'","Engineering","Bachelor's degree","6","6","0","0","0","0","0","0","0","0","0","0","6","6","0","0","0","0","0","0","0","0","0","0","0","0","0","0","0","0","-2"
"460376","Fairfax University of America","2019","First major","'14'","Engineering","Master's degree","2","1","1","0","0","0","0","0","0","1","1","0","0","0","0","0","0","0","0","0","0","0","0","0","1","0","1","0","0","0","-2"
"460464","Norco College","2019","First major","'14'","Engineering","Associate's degree","16","12","4","0","0","0","4","3","1","1","1","0","6","5","1","0","0","0","5","3","2","0","0","0","0","0","0","0","0","0","-2"
"464226","Ottawa University-Surprise","2019","First major","'14'","Engineering","Bachelor's degree","0","0","0","0","0","0","0","0","0","0","0","0","0","0","0","0","0","0","0","0","0","0","0","0","0","0","0","0","0","0","-2"
"479956","Pennsylvania State University-World Campus","2019","First major","'14'","Engineering","Bachelor's degree","1","1","0","0","0","0","0","0","0","0","0","0","0","0","0","0","0","0","1","1","0","0","0","0","0","0","0","0","0","0","-2"
"479956","Pennsylvania State University-World Campus","2019","First major","'14'","Engineering","Master's degree","186","144","42","0","0","0","15","13","2","5","3","2","19","14","5","0","0","0","123","96","27","8","8","0","7","4","3","9","6","3","-2"
"480657","Rasmussen University-Kansas","2019","First major","'14'","Engineering","Associate's degree","0","0","0","0","0","0","0","0","0","0","0","0","0","0","0","0","0","0","0","0","0","0","0","0","0","0","0","0","0","0","-2"
"482422","DeVry University-Arizona","2019","First major","'14'","Engineering","Bachelor's degree","2","2","0","0","0","0","0","0","0","0","0","0","1","1","0","0","0","0","1","1","0","0","0","0","0","0","0","0","0","0","-2"
"482431","DeVry University-California","2019","First major","'14'","Engineering","Bachelor's degree","4","3","1","0","0","0","0","0","0","0","0","0","2","1","1","0","0","0","2","2","0","0","0","0","0","0","0","0","0","0","-2"
"482459","DeVry University-Florida","2019","First major","'14'","Engineering","Bachelor's degree","1","1","0","0","0","0","0","0","0","0","0","0","0","0","0","0","0","0","1","1","0","0","0","0","0","0","0","0","0","0","-2"
"482468","DeVry University-Georgia","2019","First major","'14'","Engineering","Bachelor's degree","0","0","0","0","0","0","0","0","0","0","0","0","0","0","0","0","0","0","0","0","0","0","0","0","0","0","0","0","0","0","-2"
"482477","DeVry University-Illinois","2019","First major","'14'","Engineering","Bachelor's degree","0","0","0","0","0","0","0","0","0","0","0","0","0","0","0","0","0","0","0","0","0","0","0","0","0","0","0","0","0","0","-2"
"482477","DeVry University-Illinois","2019","First major","'14'","Engineering","Master's degree","0","0","0","0","0","0","0","0","0","0","0","0","0","0","0","0","0","0","0","0","0","0","0","0","0","0","0","0","0","0","-2"
"482574","DeVry University-Ohio","2019","First major","'14'","Engineering","Bachelor's degree","0","0","0","0","0","0","0","0","0","0","0","0","0","0","0","0","0","0","0","0","0","0","0","0","0","0","0","0","0","0","-2"
"482608","DeVry University-Pennsylvania","2019","First major","'14'","Engineering","Bachelor's degree","0","0","0","0","0","0","0","0","0","0","0","0","0","0","0","0","0","0","0","0","0","0","0","0","0","0","0","0","0","0","-2"
"482635","DeVry University-Texas","2019","First major","'14'","Engineering","Bachelor's degree","0","0","0","0","0","0","0","0","0","0","0","0","0","0","0","0","0","0","0","0","0","0","0","0","0","0","0","0","0","0","-2"
"482653","DeVry University-Virginia","2019","First major","'14'","Engineering","Bachelor's degree","0","0","0","0","0","0","0","0","0","0","0","0","0","0","0","0","0","0","0","0","0","0","0","0","0","0","0","0","0","0","-2"
"482705","Northeastern University Lifelong Learning Network","2019","First major","'14'","Engineering","Master's degree","53","22","31","0","0","0","1","0","1","0","0","0","0","0","0","0","0","0","0","0","0","0","0","0","0","0","0","52","22","30","-2"
"482936","Florida Polytechnic University","2019","First major","'14'","Engineering","Bachelor's degree","114","93","21","0","0","0","6","6","0","3","3","0","24","17","7","0","0","0","73","61","12","1","1","0","4","4","0","3","1","2","-2"
"482936","Florida Polytechnic University","2019","First major","'14'","Engineering","Master's degree","2","2","0","0","0","0","0","0","0","0","0","0","0","0","0","0","0","0","1","1","0","0","0","0","0","0","0","1","1","0","-2"
"483124","Arizona State University Digital Immersion","2019","First major","'14'","Engineering","Bachelor's degree","169","141","28","0","0","0","9","6","3","2","2","0","13","13","0","1","1","0","136","112","24","6","5","1","2","2","0","0","0","0","-2"
"483124","Arizona State University Digital Immersion","2019","First major","'14'","Engineering","Master's degree","91","74","17","0","0","0","5","4","1","1","1","0","15","13","2","0","0","0","59","47","12","2","2","0","4","3","1","5","4","1","-2"
"484473","University of Florida-Online","2019","First major","'14'","Engineering","Bachelor's degree","1","1","0","0","0","0","0","0","0","0","0","0","0","0","0","0","0","0","1","1","0","0","0","0","0","0","0","0","0","0","-2"
"485768","Atlantis University","2019","First major","'14'","Engineering","Bachelor's degree","0","0","0","0","0","0","0","0","0","0","0","0","0","0","0","0","0","0","0","0","0","0","0","0","0","0","0","0","0","0","-2"
"485768","Atlantis University","2019","First major","'14'","Engineering","Master's degree","3","3","0","0","0","0","0","0","0","1","1","0","1","1","0","0","0","0","0","0","0","0","0","0","0","0","0","1","1","0","-2"
"486840","Kennesaw State University","2019","First major","'14'","Engineering","Bachelor's degree","524","455","69","1","1","0","49","38","11","87","73","14","66","59","7","0","0","0","267","240","27","25","19","6","8","8","0","21","17","4","-2"
"486840","Kennesaw State University","2019","First major","'14'","Engineering","Master's degree","51","42","9","0","0","0","5","3","2","11","7","4","3","3","0","0","0","0","24","22","2","3","3","0","0","0","0","5","4","1","-2"
"486901","Milligan University","2019","First major","'14'","Engineering","Bachelor's degree","0","0","0","0","0","0","0","0","0","0","0","0","0","0","0","0","0","0","0","0","0","0","0","0","0","0","0","0","0","0","-2"
"487010","The University of Tennessee Health Science Center","2019","First major","'14'","Engineering","Master's degree","1","1","0","0","0","0","0","0","0","0","0","0","0","0","0","0","0","0","1","1","0","0","0","0","0","0","0","0","0","0","-2"
"487010","The University of Tennessee Health Science Center","2019","First major","'14'","Engineering","Doctor's degree - research/scholarship","0","0","0","0","0","0","0","0","0","0","0","0","0","0","0","0","0","0","0","0","0","0","0","0","0","0","0","0","0","0","-2"
"487320","Texas State Technical College","2019","First major","'14'","Engineering","Associate's degree","11","10","1","0","0","0","0","0","0","0","0","0","9","9","0","0","0","0","0","0","0","0","0","0","2","1","1","0","0","0","-2"
"489201","Clovis Community College","2019","First major","'14'","Engineering","Associate's degree","9","9","0","0","0","0","0","0","0","0","0","0","7","7","0","0","0","0","2","2","0","0","0","0","0","0","0","0","0","0","-2"
"490373","Western Michigan University Homer Stryker M.D. School of Medicine","2019","First major","'14'","Engineering","Master's degree","0","0","0","0","0","0","0","0","0","0","0","0","0","0","0","0","0","0","0","0","0","0","0","0","0","0","0","0","0","0","-2"
"490805","Purdue University Northwest","2019","First major","'14'","Engineering","Bachelor's degree","164","142","22","0","0","0","3","3","0","6","6","0","35","34","1","0","0","0","91","76","15","0","0","0","1","1","0","28","22","6","-2"
"490805","Purdue University Northwest","2019","First major","'14'","Engineering","Master's degree","42","35","7","0","0","0","0","0","0","1","1","0","3","3","0","0","0","0","3","3","0","0","0","0","0","0","0","35","28","7","-2"
"492962","Indiana Institute of Technology-College of Professional Studies","2019","First major","'14'","Engineering","Associate's degree","5","4","1","0","0","0","0","0","0","0","0","0","0","0","0","0","0","0","2","2","0","0","0","0","3","2","1","0","0","0","-2"
"492962","Indiana Institute of Technology-College of Professional Studies","2019","First major","'14'","Engineering","Bachelor's degree","12","10","2","0","0","0","0","0","0","2","0","2","0","0","0","0","0","0","8","8","0","0","0","0","2","2","0","0","0","0","-2"
